"State","date","Year","Month","jolts","bgt","diff","per_diff","Month2","time"
"Alabama","2010-01",2010,1,38000,4688,33312,156.071964017991,"01",2010-01-01
"Alabama","2010-10",2010,10,46000,16997,29003,92.0774005111355,"10",2010-10-01
"Alabama","2010-11",2010,11,44000,12425,31575,111.918475852902,"11",2010-11-01
"Alabama","2010-12",2010,12,43000,14182,28818,100.793956140044,"12",2010-12-01
"Alabama","2010-02",2010,2,38000,7088,30912,137.118523775727,"02",2010-02-01
"Alabama","2010-03",2010,3,40000,12015,27985,107.60357589157,"03",2010-03-01
"Alabama","2010-04",2010,4,42000,11427,30573,114.447751137066,"04",2010-04-01
"Alabama","2010-05",2010,5,46000,14940,31060,101.936330817197,"05",2010-05-01
"Alabama","2010-06",2010,6,46000,12834,33166,112.744331508991,"06",2010-06-01
"Alabama","2010-07",2010,7,45000,14710,30290,101.457042371462,"07",2010-07-01
"Alabama","2010-08",2010,8,44000,17136,26864,87.882753205967,"08",2010-08-01
"Alabama","2010-09",2010,9,46000,14701,31299,103.125154445561,"09",2010-09-01
"Alabama","2011-01",2011,1,43000,11424,31576,116.037042481258,"01",2011-01-01
"Alabama","2011-10",2011,10,59000,15244,43756,117.870804374764,"10",2011-10-01
"Alabama","2011-11",2011,11,57000,12173,44827,129.6083732092,"11",2011-11-01
"Alabama","2011-12",2011,12,55000,9258,45742,142.369821656447,"12",2011-12-01
"Alabama","2011-02",2011,2,46000,13079,32921,111.447384011239,"02",2011-02-01
"Alabama","2011-03",2011,3,46000,21774,24226,71.4905420957889,"03",2011-03-01
"Alabama","2011-04",2011,4,47000,16125,30875,97.8217821782178,"04",2011-04-01
"Alabama","2011-05",2011,5,47000,18034,28966,89.0795583848448,"05",2011-05-01
"Alabama","2011-06",2011,6,49000,17346,31654,95.4209748892171,"06",2011-06-01
"Alabama","2011-07",2011,7,56000,21591,34409,88.693276282043,"07",2011-07-01
"Alabama","2011-08",2011,8,57000,23884,33116,81.8851688838336,"08",2011-08-01
"Alabama","2011-09",2011,9,64000,16498,47502,118.020323486298,"09",2011-09-01
"Alabama","2012-01",2012,1,60000,17603,42397,109.266394340425,"01",2012-01-01
"Alabama","2012-10",2012,10,54000,10117,43883,136.884133693092,"10",2012-10-01
"Alabama","2012-11",2012,11,51000,19446,31554,89.58351077421,"11",2012-11-01
"Alabama","2012-12",2012,12,46000,9824,36176,129.607337345944,"12",2012-12-01
"Alabama","2012-02",2012,2,69000,17735,51265,118.2106416095,"02",2012-02-01
"Alabama","2012-03",2012,3,77000,17690,59310,125.271940014785,"03",2012-03-01
"Alabama","2012-04",2012,4,77000,22886,54114,108.351520733636,"04",2012-04-01
"Alabama","2012-05",2012,5,73000,18462,54538,119.258271194594,"05",2012-05-01
"Alabama","2012-06",2012,6,64000,15470,48530,122.13413866868,"06",2012-06-01
"Alabama","2012-07",2012,7,60000,12473,47527,131.157810494943,"07",2012-07-01
"Alabama","2012-08",2012,8,55000,9276,45724,142.273943618147,"08",2012-08-01
"Alabama","2012-09",2012,9,56000,14119,41881,119.456923230508,"09",2012-09-01
"Alabama","2013-01",2013,1,48000,16022,31978,99.8969104370373,"01",2013-01-01
"Alabama","2013-10",2013,10,47000,25651,21349,58.771386491583,"10",2013-10-01
"Alabama","2013-11",2013,11,46000,20284,25716,77.5933860358458,"11",2013-11-01
"Alabama","2013-12",2013,12,46000,17688,28312,88.9084285893732,"12",2013-12-01
"Alabama","2013-02",2013,2,54000,11685,42315,128.842201415848,"02",2013-02-01
"Alabama","2013-03",2013,3,59000,14900,44100,119.350473612991,"03",2013-03-01
"Alabama","2013-04",2013,4,62000,11533,50467,137.263541539173,"04",2013-04-01
"Alabama","2013-05",2013,5,61000,17675,43325,110.136638068001,"05",2013-05-01
"Alabama","2013-06",2013,6,58000,25638,32362,77.3858772328367,"06",2013-06-01
"Alabama","2013-07",2013,7,52000,22718,29282,78.3800422923526,"07",2013-07-01
"Alabama","2013-08",2013,8,49000,22697,26303,73.3726655229647,"08",2013-08-01
"Alabama","2013-09",2013,9,46000,29192,16808,44.7068837110331,"09",2013-09-01
"Alabama","2014-01",2014,1,46000,22299,23701,69.4036515907993,"01",2014-01-01
"Alabama","2014-10",2014,10,65000,21140,43860,101.834223357325,"10",2014-10-01
"Alabama","2014-11",2014,11,60000,13161,46839,128.043629802764,"11",2014-11-01
"Alabama","2014-12",2014,12,60000,14367,45633,122.72378877728,"12",2014-12-01
"Alabama","2014-02",2014,2,51000,20284,30716,86.179226754952,"02",2014-02-01
"Alabama","2014-03",2014,3,54000,27116,26884,66.2853197889442,"03",2014-03-01
"Alabama","2014-04",2014,4,58000,22567,35433,87.9590899499795,"04",2014-04-01
"Alabama","2014-05",2014,5,59000,21696,37304,92.4556359670864,"05",2014-05-01
"Alabama","2014-06",2014,6,61000,16302,44698,115.645132079377,"06",2014-06-01
"Alabama","2014-07",2014,7,60000,12890,47110,129.26327342571,"07",2014-07-01
"Alabama","2014-08",2014,8,62000,20148,41852,101.894142279788,"08",2014-08-01
"Alabama","2014-09",2014,9,62000,18488,43512,108.120465162509,"09",2014-09-01
"Alabama","2015-01",2015,1,61000,13727,47273,126.521872950875,"01",2015-01-01
"Alabama","2015-10",2015,10,77000,22401,54599,109.856037665617,"10",2015-10-01
"Alabama","2015-11",2015,11,76000,15789,60211,131.194369695715,"11",2015-11-01
"Alabama","2015-12",2015,12,76000,17340,58660,125.691022069852,"12",2015-12-01
"Alabama","2015-02",2015,2,66000,11642,54358,140.02215295845,"02",2015-02-01
"Alabama","2015-03",2015,3,70000,17731,52269,119.157424399585,"03",2015-03-01
"Alabama","2015-04",2015,4,73000,18970,54030,117.494835272371,"04",2015-04-01
"Alabama","2015-05",2015,5,75000,27398,47602,92.9744721576593,"05",2015-05-01
"Alabama","2015-06",2015,6,73000,28088,44912,88.8572333016778,"06",2015-06-01
"Alabama","2015-07",2015,7,74000,26204,47796,95.3973893257754,"07",2015-07-01
"Alabama","2015-08",2015,8,76000,22465,53535,108.739145889402,"08",2015-08-01
"Alabama","2015-09",2015,9,78000,24582,53418,104.14692636135,"09",2015-09-01
"Alabama","2016-01",2016,1,76000,22593,53407,108.338320164718,"01",2016-01-01
"Alabama","2016-10",2016,10,71000,37315,33685,62.1982181599963,"10",2016-10-01
"Alabama","2016-11",2016,11,69000,24437,44563,95.386196046534,"11",2016-11-01
"Alabama","2016-12",2016,12,66000,21459,44541,101.85572668336,"12",2016-12-01
"Alabama","2016-02",2016,2,78000,22007,55993,111.978161528693,"02",2016-02-01
"Alabama","2016-03",2016,3,82000,23761,58239,110.133224912775,"03",2016-03-01
"Alabama","2016-04",2016,4,84000,29111,54889,97.0533369875609,"04",2016-04-01
"Alabama","2016-05",2016,5,83000,26709,56291,102.618745955209,"05",2016-05-01
"Alabama","2016-06",2016,6,81000,30713,50287,90.0289133762409,"06",2016-06-01
"Alabama","2016-07",2016,7,80000,27991,52009,96.3209897121056,"07",2016-07-01
"Alabama","2016-08",2016,8,77000,28221,48779,92.7172332519174,"08",2016-08-01
"Alabama","2016-09",2016,9,76000,33220,42780,78.3373008606482,"09",2016-09-01
"Alabama","2017-01",2017,1,66000,25366,40634,88.9477486154587,"01",2017-01-01
"Alabama","2017-10",2017,10,80000,19841,60159,120.509610280346,"10",2017-10-01
"Alabama","2017-11",2017,11,80000,16438,63562,131.819407287584,"11",2017-11-01
"Alabama","2017-12",2017,12,77000,20179,56821,116.940902869962,"12",2017-12-01
"Alabama","2017-02",2017,2,67000,25775,41225,88.87092427917,"02",2017-02-01
"Alabama","2017-03",2017,3,68000,33603,34397,67.7086306506698,"03",2017-03-01
"Alabama","2017-04",2017,4,75000,25070,49930,99.790146897172,"04",2017-04-01
"Alabama","2017-05",2017,5,76000,25608,50392,99.1890402330525,"05",2017-05-01
"Alabama","2017-06",2017,6,82000,26075,55925,103.492944714319,"06",2017-06-01
"Alabama","2017-07",2017,7,83000,27109,55891,101.519403500168,"07",2017-07-01
"Alabama","2017-08",2017,8,84000,24255,59745,110.378273520854,"08",2017-08-01
"Alabama","2017-09",2017,9,83000,21599,61401,117.402652033002,"09",2017-09-01
"Alabama","2018-01",2018,1,76000,27446,48554,93.8731318755679,"01",2018-01-01
"Alabama","2018-10",2018,10,96000,26185,69815,114.277529975038,"10",2018-10-01
"Alabama","2018-11",2018,11,95000,24482,70518,118.039537336168,"11",2018-11-01
"Alabama","2018-12",2018,12,93000,27377,65623,109.029133472341,"12",2018-12-01
"Alabama","2018-02",2018,2,81000,26147,54853,102.388307652104,"02",2018-02-01
"Alabama","2018-03",2018,3,89000,36570,52430,83.5072071354623,"03",2018-03-01
"Alabama","2018-04",2018,4,96000,28142,67858,109.323194406406,"04",2018-04-01
"Alabama","2018-05",2018,5,98000,29886,68114,106.522997044243,"05",2018-05-01
"Alabama","2018-06",2018,6,96000,18466,77534,135.47079482117,"06",2018-06-01
"Alabama","2018-07",2018,7,97000,30951,66049,103.241084477652,"07",2018-07-01
"Alabama","2018-08",2018,8,96000,24706,71294,118.128344904147,"08",2018-08-01
"Alabama","2018-09",2018,9,97000,21676,75324,126.940577707371,"09",2018-09-01
"Alabama","2019-01",2019,1,91000,26356,64644,110.16735403388,"01",2019-01-01
"Alabama","2019-10",2019,10,105000,36684,68316,96.4343186245448,"10",2019-10-01
"Alabama","2019-11",2019,11,102000,42493,59507,82.366619836255,"11",2019-11-01
"Alabama","2019-12",2019,12,92000,25601,66399,112.922509162337,"12",2019-12-01
"Alabama","2019-02",2019,2,91000,25950,65050,111.24412141941,"02",2019-02-01
"Alabama","2019-03",2019,3,96000,33463,62537,96.6098421942949,"03",2019-03-01
"Alabama","2019-04",2019,4,1e+05,37971,62029,89.9159968399156,"04",2019-04-01
"Alabama","2019-05",2019,5,103000,37537,65463,93.1612315617951,"05",2019-05-01
"Alabama","2019-06",2019,6,104000,33132,70868,103.357349123472,"06",2019-06-01
"Alabama","2019-07",2019,7,1e+05,29568,70432,108.718202025191,"07",2019-07-01
"Alabama","2019-08",2019,8,97000,37904,59096,87.6119314475479,"08",2019-08-01
"Alabama","2019-09",2019,9,98000,34935,63065,94.8809568586151,"09",2019-09-01
"Alaska","2010-01",2010,1,9000,536,8464,177.51677852349,"01",2010-01-01
"Alaska","2010-10",2010,10,11000,7276,3724,40.7528999781134,"10",2010-10-01
"Alaska","2010-11",2010,11,10000,5972,4028,50.4382669671926,"11",2010-11-01
"Alaska","2010-12",2010,12,10000,6105,3895,48.3700714063955,"12",2010-12-01
"Alaska","2010-02",2010,2,10000,6604,3396,40.9058058299205,"02",2010-02-01
"Alaska","2010-03",2010,3,10000,3547,6453,95.2683250904259,"03",2010-03-01
"Alaska","2010-04",2010,4,11000,5896,5104,60.4166666666667,"04",2010-04-01
"Alaska","2010-05",2010,5,13000,8317,4683,43.9367640850026,"05",2010-05-01
"Alaska","2010-06",2010,6,15000,6922,8078,73.6976553234194,"06",2010-06-01
"Alaska","2010-07",2010,7,16000,8723,7277,58.8682603243943,"07",2010-07-01
"Alaska","2010-08",2010,8,14000,7722,6278,57.8031488813185,"08",2010-08-01
"Alaska","2010-09",2010,9,12000,6090,5910,65.3399668325041,"09",2010-09-01
"Alaska","2011-01",2011,1,9000,6392,2608,33.8877338877339,"01",2011-01-01
"Alaska","2011-10",2011,10,12000,3786,8214,104.066894716838,"10",2011-10-01
"Alaska","2011-11",2011,11,10000,3032,6968,106.936771025169,"11",2011-11-01
"Alaska","2011-12",2011,12,9000,2511,6489,112.744331508991,"12",2011-12-01
"Alaska","2011-02",2011,2,10000,5217,4783,62.8639022146284,"02",2011-02-01
"Alaska","2011-03",2011,3,10000,6596,3404,41.0219329959026,"03",2011-03-01
"Alaska","2011-04",2011,4,12000,4936,7064,83.4199338686821,"04",2011-04-01
"Alaska","2011-05",2011,5,14000,5785,8215,83.042709123073,"05",2011-05-01
"Alaska","2011-06",2011,6,17000,5356,11644,104.16890320272,"06",2011-06-01
"Alaska","2011-07",2011,7,18000,5605,12395,105.020122855327,"07",2011-07-01
"Alaska","2011-08",2011,8,16000,5830,10170,93.1745304626661,"08",2011-08-01
"Alaska","2011-09",2011,9,13000,4869,8131,91.0067715037215,"09",2011-09-01
"Alaska","2012-01",2012,1,10000,4778,5222,70.6726214643389,"01",2012-01-01
"Alaska","2012-10",2012,10,11000,3577,7423,101.845372847637,"10",2012-10-01
"Alaska","2012-11",2012,11,10000,9947,53,0.531408231814308,"11",2012-11-01
"Alaska","2012-12",2012,12,10000,4580,5420,74.3484224965706,"12",2012-12-01
"Alaska","2012-02",2012,2,11000,5354,5646,69.0473278708573,"02",2012-02-01
"Alaska","2012-03",2012,3,11000,7251,3749,41.0826804010739,"03",2012-03-01
"Alaska","2012-04",2012,4,12000,4883,7117,84.3096606053427,"04",2012-04-01
"Alaska","2012-05",2012,5,14000,6927,7073,67.596884407703,"05",2012-05-01
"Alaska","2012-06",2012,6,16000,10874,5126,38.1483962193942,"06",2012-06-01
"Alaska","2012-07",2012,7,16000,3872,12128,122.061191626409,"07",2012-07-01
"Alaska","2012-08",2012,8,14000,3406,10594,121.728139721935,"08",2012-08-01
"Alaska","2012-09",2012,9,12000,9418,2582,24.110561210197,"09",2012-09-01
"Alaska","2013-01",2013,1,10000,5185,4815,63.4178465591044,"01",2013-01-01
"Alaska","2013-10",2013,10,12000,5640,6360,72.108843537415,"10",2013-10-01
"Alaska","2013-11",2013,11,10000,5875,4125,51.9685039370079,"11",2013-11-01
"Alaska","2013-12",2013,12,10000,5084,4916,65.1816494298595,"12",2013-12-01
"Alaska","2013-02",2013,2,12000,4626,7374,88.704438830747,"02",2013-02-01
"Alaska","2013-03",2013,3,13000,4033,8967,105.289731697294,"03",2013-03-01
"Alaska","2013-04",2013,4,14000,3378,10622,122.246518586719,"04",2013-04-01
"Alaska","2013-05",2013,5,16000,4063,11937,118.995165229527,"05",2013-05-01
"Alaska","2013-06",2013,6,18000,6632,11368,92.3026956804157,"06",2013-06-01
"Alaska","2013-07",2013,7,18000,6121,11879,98.4950872683554,"07",2013-07-01
"Alaska","2013-08",2013,8,16000,6329,9671,86.6227775538537,"08",2013-08-01
"Alaska","2013-09",2013,9,13000,6330,6670,69.0118986032074,"09",2013-09-01
"Alaska","2014-01",2014,1,11000,6030,4970,58.3675866118614,"01",2014-01-01
"Alaska","2014-10",2014,10,14000,9724,4276,36.0478839993256,"10",2014-10-01
"Alaska","2014-11",2014,11,13000,7850,5150,49.400479616307,"11",2014-11-01
"Alaska","2014-12",2014,12,12000,6888,5112,54.1296060991105,"12",2014-12-01
"Alaska","2014-02",2014,2,13000,6472,6528,67.050123253903,"02",2014-02-01
"Alaska","2014-03",2014,3,15000,6487,8513,79.2386093917252,"03",2014-03-01
"Alaska","2014-04",2014,4,16000,7645,8355,70.6703319940791,"04",2014-04-01
"Alaska","2014-05",2014,5,19000,7452,11548,87.312868592167,"05",2014-05-01
"Alaska","2014-06",2014,6,23000,6856,16144,108.145766345123,"06",2014-06-01
"Alaska","2014-07",2014,7,23000,5480,17520,123.033707865169,"07",2014-07-01
"Alaska","2014-08",2014,8,20000,6932,13068,97.0444081390168,"08",2014-08-01
"Alaska","2014-09",2014,9,16000,6023,9977,90.6052763020479,"09",2014-09-01
"Alaska","2015-01",2015,1,14000,6651,7349,71.1733087986054,"01",2015-01-01
"Alaska","2015-10",2015,10,15000,6059,8941,84.9138135713947,"10",2015-10-01
"Alaska","2015-11",2015,11,14000,4276,9724,106.412781790326,"11",2015-11-01
"Alaska","2015-12",2015,12,14000,4604,9396,101.010535368738,"12",2015-12-01
"Alaska","2015-02",2015,2,15000,5534,9466,92.1983052498295,"02",2015-02-01
"Alaska","2015-03",2015,3,16000,5714,10286,94.7407202726352,"03",2015-03-01
"Alaska","2015-04",2015,4,17000,6777,10223,85.990663245994,"04",2015-04-01
"Alaska","2015-05",2015,5,21000,7762,13238,92.0520130728044,"05",2015-05-01
"Alaska","2015-06",2015,6,23000,6826,16174,108.45570978341,"06",2015-06-01
"Alaska","2015-07",2015,7,25000,6219,18781,120.317755213171,"07",2015-07-01
"Alaska","2015-08",2015,8,21000,6448,14552,106.033226464588,"08",2015-08-01
"Alaska","2015-09",2015,9,18000,6365,11635,95.5058485532526,"09",2015-09-01
"Alaska","2016-01",2016,1,15000,5337,9663,95.0287653046172,"01",2016-01-01
"Alaska","2016-10",2016,10,15000,6027,8973,85.34741047225,"10",2016-10-01
"Alaska","2016-11",2016,11,14000,6697,7303,70.5706140986617,"11",2016-11-01
"Alaska","2016-12",2016,12,14000,6401,7599,74.4963482182246,"12",2016-12-01
"Alaska","2016-02",2016,2,16000,5645,10355,95.6802956802957,"02",2016-02-01
"Alaska","2016-03",2016,3,16000,6156,9844,88.8608051994945,"03",2016-03-01
"Alaska","2016-04",2016,4,18000,6495,11505,93.937538273117,"04",2016-04-01
"Alaska","2016-05",2016,5,22000,5627,16373,118.528975277808,"05",2016-05-01
"Alaska","2016-06",2016,6,27000,6575,20425,121.667907669397,"06",2016-06-01
"Alaska","2016-07",2016,7,26000,6171,19829,123.272512511268,"07",2016-07-01
"Alaska","2016-08",2016,8,22000,5537,16463,119.570033046447,"08",2016-08-01
"Alaska","2016-09",2016,9,18000,7316,10684,84.4051192921473,"09",2016-09-01
"Alaska","2017-01",2017,1,15000,6233,8767,82.5790043799746,"01",2017-01-01
"Alaska","2017-10",2017,10,17000,5273,11727,105.30238405244,"10",2017-10-01
"Alaska","2017-11",2017,11,15000,4183,10817,112.776937913778,"11",2017-11-01
"Alaska","2017-12",2017,12,15000,3530,11470,123.79924446843,"12",2017-12-01
"Alaska","2017-02",2017,2,16000,7034,8966,77.8501345836589,"02",2017-02-01
"Alaska","2017-03",2017,3,16000,7336,8664,74.2543709290367,"03",2017-03-01
"Alaska","2017-04",2017,4,16000,5824,10176,93.2551319648094,"04",2017-04-01
"Alaska","2017-05",2017,5,20000,6649,13351,100.198881759165,"05",2017-05-01
"Alaska","2017-06",2017,6,25000,6082,18918,121.729618428673,"06",2017-06-01
"Alaska","2017-07",2017,7,27000,6870,20130,118.866253321523,"07",2017-07-01
"Alaska","2017-08",2017,8,24000,5073,18927,130.203281395109,"08",2017-08-01
"Alaska","2017-09",2017,9,19000,5666,13334,108.11643557934,"09",2017-09-01
"Alaska","2018-01",2018,1,15000,4643,10357,105.452323983098,"01",2018-01-01
"Alaska","2018-10",2018,10,19000,5471,13529,110.571697110866,"10",2018-10-01
"Alaska","2018-11",2018,11,17000,5954,11046,96.2446632395225,"11",2018-11-01
"Alaska","2018-12",2018,12,17000,4862,12138,111.04199066874,"12",2018-12-01
"Alaska","2018-02",2018,2,17000,5067,11933,108.152444827117,"02",2018-02-01
"Alaska","2018-03",2018,3,19000,6153,12847,102.150836878305,"03",2018-03-01
"Alaska","2018-04",2018,4,20000,6596,13404,100.797112347721,"04",2018-04-01
"Alaska","2018-05",2018,5,24000,7239,16761,107.308172476712,"05",2018-05-01
"Alaska","2018-06",2018,6,30000,5486,24514,138.161528490109,"06",2018-06-01
"Alaska","2018-07",2018,7,33000,6766,26234,131.9418598803,"07",2018-07-01
"Alaska","2018-08",2018,8,29000,6839,22161,123.669745249588,"08",2018-08-01
"Alaska","2018-09",2018,9,23000,5718,17282,120.356570791838,"09",2018-09-01
"Alaska","2019-01",2019,1,18000,5156,12844,110.934531007082,"01",2019-01-01
"Alaska","2019-10",2019,10,18000,7112,10888,86.7155144950621,"10",2019-10-01
"Alaska","2019-11",2019,11,16000,6974,9026,78.5757813180117,"11",2019-11-01
"Alaska","2019-12",2019,12,16000,6733,9267,81.5290546782211,"12",2019-12-01
"Alaska","2019-02",2019,2,20000,4904,15096,121.23353678124,"02",2019-02-01
"Alaska","2019-03",2019,3,20000,7366,12634,92.3335525834978,"03",2019-03-01
"Alaska","2019-04",2019,4,21000,6377,14623,106.826898491434,"04",2019-04-01
"Alaska","2019-05",2019,5,26000,6991,19009,115.237489012155,"05",2019-05-01
"Alaska","2019-06",2019,6,31000,5842,25158,136.572390206829,"06",2019-06-01
"Alaska","2019-07",2019,7,33000,4143,28857,155.383248525967,"07",2019-07-01
"Alaska","2019-08",2019,8,29000,5109,23891,140.08619425958,"08",2019-08-01
"Alaska","2019-09",2019,9,22000,7700,14300,96.2962962962963,"09",2019-09-01
"Arizona","2010-01",2010,1,49000,6484,42516,153.25499243025,"01",2010-01-01
"Arizona","2010-10",2010,10,73000,32667,40333,76.339822271854,"10",2010-10-01
"Arizona","2010-11",2010,11,74000,29902,44098,84.8838328424862,"11",2010-11-01
"Arizona","2010-12",2010,12,73000,40059,32941,58.2722295438665,"12",2010-12-01
"Arizona","2010-02",2010,2,54000,19347,34653,94.4905722115424,"02",2010-02-01
"Arizona","2010-03",2010,3,60000,16642,43358,113.144229012813,"03",2010-03-01
"Arizona","2010-04",2010,4,61000,18442,42558,107.142317665718,"04",2010-04-01
"Arizona","2010-05",2010,5,58000,21584,36416,91.5158825894652,"05",2010-05-01
"Arizona","2010-06",2010,6,59000,20212,38788,97.9346563651972,"06",2010-06-01
"Arizona","2010-07",2010,7,59000,25388,33612,79.6606152533536,"07",2010-07-01
"Arizona","2010-08",2010,8,63000,29521,33479,72.3705969455583,"08",2010-08-01
"Arizona","2010-09",2010,9,66000,25404,40596,88.8276224235263,"09",2010-09-01
"Arizona","2011-01",2011,1,65000,31339,33661,69.8803184587758,"01",2011-01-01
"Arizona","2011-10",2011,10,81000,32727,48273,84.8927695270253,"10",2011-10-01
"Arizona","2011-11",2011,11,85000,21436,63564,119.44079070991,"11",2011-11-01
"Arizona","2011-12",2011,12,80000,24581,55419,105.982922328148,"12",2011-12-01
"Arizona","2011-02",2011,2,59000,42768,16232,31.9000078610172,"02",2011-02-01
"Arizona","2011-03",2011,3,61000,44477,16523,31.3300529973359,"03",2011-03-01
"Arizona","2011-04",2011,4,64000,35913,28087,56.2229139351236,"04",2011-04-01
"Arizona","2011-05",2011,5,62000,45596,16404,30.4918398453474,"05",2011-05-01
"Arizona","2011-06",2011,6,64000,26750,37250,82.0936639118457,"06",2011-06-01
"Arizona","2011-07",2011,7,68000,39248,28752,53.617783082202,"07",2011-07-01
"Arizona","2011-08",2011,8,74000,40736,33264,57.9835448333566,"08",2011-08-01
"Arizona","2011-09",2011,9,79000,28232,50768,94.6881527902119,"09",2011-09-01
"Arizona","2012-01",2012,1,79000,26990,52010,98.1413340881215,"01",2012-01-01
"Arizona","2012-10",2012,10,79000,20777,58223,116.706254948535,"10",2012-10-01
"Arizona","2012-11",2012,11,79000,28725,50275,93.3395219308424,"11",2012-11-01
"Arizona","2012-12",2012,12,82000,25164,56836,106.072934940838,"12",2012-12-01
"Arizona","2012-02",2012,2,73000,29800,43200,84.0466926070039,"02",2012-02-01
"Arizona","2012-03",2012,3,78000,29602,48398,89.9574357353953,"03",2012-03-01
"Arizona","2012-04",2012,4,79000,24083,54917,106.549091508784,"04",2012-04-01
"Arizona","2012-05",2012,5,79000,33105,45895,81.8785959591454,"05",2012-05-01
"Arizona","2012-06",2012,6,76000,32680,43320,79.7202797202797,"06",2012-06-01
"Arizona","2012-07",2012,7,74000,25847,48153,96.4535739681713,"07",2012-07-01
"Arizona","2012-08",2012,8,80000,17895,62105,126.880841718167,"08",2012-08-01
"Arizona","2012-09",2012,9,78000,21703,56297,112.929400318947,"09",2012-09-01
"Arizona","2013-01",2013,1,85000,28213,56787,100.318867974526,"01",2013-01-01
"Arizona","2013-10",2013,10,86000,37625,48375,78.2608695652174,"10",2013-10-01
"Arizona","2013-11",2013,11,85000,41679,43321,68.3949194420543,"11",2013-11-01
"Arizona","2013-12",2013,12,82000,35213,46787,79.832441793999,"12",2013-12-01
"Arizona","2013-02",2013,2,89000,23594,65406,116.180258273087,"02",2013-02-01
"Arizona","2013-03",2013,3,94000,23471,70529,120.078998220837,"03",2013-03-01
"Arizona","2013-04",2013,4,97000,18423,78577,136.15483915684,"04",2013-04-01
"Arizona","2013-05",2013,5,92000,26755,65245,109.881689192034,"05",2013-05-01
"Arizona","2013-06",2013,6,85000,37051,47949,78.5720723304192,"06",2013-06-01
"Arizona","2013-07",2013,7,76000,41697,34303,58.2903557439867,"07",2013-07-01
"Arizona","2013-08",2013,8,77000,40613,36387,61.8758130478774,"08",2013-08-01
"Arizona","2013-09",2013,9,78000,41246,36754,61.6439964443252,"09",2013-09-01
"Arizona","2014-01",2014,1,79000,41292,37708,62.694110996575,"01",2014-01-01
"Arizona","2014-10",2014,10,118000,40693,77307,97.4296282759794,"10",2014-10-01
"Arizona","2014-11",2014,11,111000,37570,73430,98.8490273944942,"11",2014-11-01
"Arizona","2014-12",2014,12,105000,39730,65270,90.1955365162717,"12",2014-12-01
"Arizona","2014-02",2014,2,87000,36850,50150,80.9850625756964,"02",2014-02-01
"Arizona","2014-03",2014,3,96000,41677,54323,78.9136892872448,"03",2014-03-01
"Arizona","2014-04",2014,4,101000,43576,57424,79.4378043382027,"04",2014-04-01
"Arizona","2014-05",2014,5,97000,37509,59491,88.4565345069847,"05",2014-05-01
"Arizona","2014-06",2014,6,102000,36431,65569,94.7316713741864,"06",2014-06-01
"Arizona","2014-07",2014,7,96000,29910,66090,104.979747438647,"07",2014-07-01
"Arizona","2014-08",2014,8,106000,38723,67277,92.9734734630985,"08",2014-08-01
"Arizona","2014-09",2014,9,108000,38658,69342,94.5628605326678,"09",2014-09-01
"Arizona","2015-01",2015,1,103000,41191,61809,85.7321192030016,"01",2015-01-01
"Arizona","2015-10",2015,10,116000,47134,68866,84.4287518236542,"10",2015-10-01
"Arizona","2015-11",2015,11,114000,42164,71836,92.000717194744,"11",2015-11-01
"Arizona","2015-12",2015,12,115000,40659,74341,95.5177663996299,"12",2015-12-01
"Arizona","2015-02",2015,2,106000,30202,75798,111.302330362256,"02",2015-02-01
"Arizona","2015-03",2015,3,109000,48296,60704,77.1844166412369,"03",2015-03-01
"Arizona","2015-04",2015,4,120000,48916,71084,84.1649103696512,"04",2015-04-01
"Arizona","2015-05",2015,5,116000,55682,60318,70.2671217716476,"05",2015-05-01
"Arizona","2015-06",2015,6,108000,54808,53192,65.3432263770822,"06",2015-06-01
"Arizona","2015-07",2015,7,1e+05,51072,48928,64.7744122008049,"07",2015-07-01
"Arizona","2015-08",2015,8,103000,49275,53725,70.5631259234937,"08",2015-08-01
"Arizona","2015-09",2015,9,111000,45886,65114,83.0080440574685,"09",2015-09-01
"Arizona","2016-01",2016,1,115000,48292,66708,81.7039414055802,"01",2016-01-01
"Arizona","2016-10",2016,10,125000,48906,76094,87.511644221591,"10",2016-10-01
"Arizona","2016-11",2016,11,121000,42871,78129,95.3542725680566,"11",2016-11-01
"Arizona","2016-12",2016,12,115000,42878,72122,91.364217940435,"12",2016-12-01
"Arizona","2016-02",2016,2,113000,44424,68576,87.1226750686045,"02",2016-02-01
"Arizona","2016-03",2016,3,117000,49733,67267,80.6882860621473,"03",2016-03-01
"Arizona","2016-04",2016,4,110000,49453,60547,75.9433814352819,"04",2016-04-01
"Arizona","2016-05",2016,5,112000,41137,70863,92.5485023214507,"05",2016-05-01
"Arizona","2016-06",2016,6,106000,45399,60601,80.0546899252967,"06",2016-06-01
"Arizona","2016-07",2016,7,112000,47403,64597,81.0486628231589,"07",2016-07-01
"Arizona","2016-08",2016,8,119000,44513,74487,91.1083522411062,"08",2016-08-01
"Arizona","2016-09",2016,9,128000,46708,81292,93.060420816448,"09",2016-09-01
"Arizona","2017-01",2017,1,112000,49655,62345,77.133401379481,"01",2017-01-01
"Arizona","2017-10",2017,10,135000,36680,98320,114.538676607642,"10",2017-10-01
"Arizona","2017-11",2017,11,131000,35440,95560,114.828166306176,"11",2017-11-01
"Arizona","2017-12",2017,12,131000,28869,102131,127.768360345032,"12",2017-12-01
"Arizona","2017-02",2017,2,110000,56158,53842,64.8081946099496,"02",2017-02-01
"Arizona","2017-03",2017,3,110000,57753,52247,62.2903912299631,"03",2017-03-01
"Arizona","2017-04",2017,4,116000,54930,61070,71.4561516410226,"04",2017-04-01
"Arizona","2017-05",2017,5,112000,54618,57382,68.8785125256575,"05",2017-05-01
"Arizona","2017-06",2017,6,118000,53872,64128,74.622975237386,"06",2017-06-01
"Arizona","2017-07",2017,7,124000,45568,78432,92.508020381204,"07",2017-07-01
"Arizona","2017-08",2017,8,135000,43595,91405,102.360088468322,"08",2017-08-01
"Arizona","2017-09",2017,9,137000,40782,96218,108.242679236368,"09",2017-09-01
"Arizona","2018-01",2018,1,129000,35715,93285,113.268372643657,"01",2018-01-01
"Arizona","2018-10",2018,10,168000,81206,86794,69.6564288179257,"10",2018-10-01
"Arizona","2018-11",2018,11,161000,79813,81187,67.4274229381304,"11",2018-11-01
"Arizona","2018-12",2018,12,159000,68507,90493,79.5518379654252,"12",2018-12-01
"Arizona","2018-02",2018,2,129000,36661,92339,111.479467104509,"02",2018-02-01
"Arizona","2018-03",2018,3,129000,50105,78895,88.0991597107842,"03",2018-03-01
"Arizona","2018-04",2018,4,141000,65006,75994,73.7784336378552,"04",2018-04-01
"Arizona","2018-05",2018,5,141000,86048,54952,48.4056234804975,"05",2018-05-01
"Arizona","2018-06",2018,6,148000,60019,87981,84.5893884693225,"06",2018-06-01
"Arizona","2018-07",2018,7,149000,83371,65629,56.486394601736,"07",2018-07-01
"Arizona","2018-08",2018,8,165000,73395,91605,76.8514440319638,"08",2018-08-01
"Arizona","2018-09",2018,9,164000,72399,91601,77.4969437264963,"09",2018-09-01
"Arizona","2019-01",2019,1,158000,64674,93326,83.8229878656691,"01",2019-01-01
"Arizona","2019-10",2019,10,150000,84047,65953,56.358765547091,"10",2019-10-01
"Arizona","2019-11",2019,11,145000,78545,66455,59.4555905969715,"11",2019-11-01
"Arizona","2019-12",2019,12,132000,78648,53352,50.6551213398656,"12",2019-12-01
"Arizona","2019-02",2019,2,164000,65321,98679,86.0618957705574,"02",2019-02-01
"Arizona","2019-03",2019,3,165000,77966,87034,71.6429459265906,"03",2019-03-01
"Arizona","2019-04",2019,4,158000,65731,92269,82.4820878644444,"04",2019-04-01
"Arizona","2019-05",2019,5,153000,81798,71202,60.6495796386681,"05",2019-05-01
"Arizona","2019-06",2019,6,148000,62002,85998,81.902077123075,"06",2019-06-01
"Arizona","2019-07",2019,7,147000,61572,85428,81.9170358437374,"07",2019-07-01
"Arizona","2019-08",2019,8,149000,86367,62633,53.2215646203588,"08",2019-08-01
"Arizona","2019-09",2019,9,159000,84355,74645,61.3465924267017,"09",2019-09-01
"Arkansas","2010-01",2010,1,22000,3501,18499,145.084506489942,"01",2010-01-01
"Arkansas","2010-10",2010,10,28000,8596,19404,106.044376434583,"10",2010-10-01
"Arkansas","2010-11",2010,11,28000,7654,20346,114.130251865148,"11",2010-11-01
"Arkansas","2010-12",2010,12,25000,9169,15831,92.6629400918962,"12",2010-12-01
"Arkansas","2010-02",2010,2,22000,4291,17709,134.715301814309,"02",2010-02-01
"Arkansas","2010-03",2010,3,23000,6067,16933,116.510131764544,"03",2010-03-01
"Arkansas","2010-04",2010,4,25000,5786,19214,124.822971480543,"04",2010-04-01
"Arkansas","2010-05",2010,5,27000,7623,19377,111.931375097479,"05",2010-05-01
"Arkansas","2010-06",2010,6,28000,7492,20508,115.564070776513,"06",2010-06-01
"Arkansas","2010-07",2010,7,28000,9334,18666,99.9946429528044,"07",2010-07-01
"Arkansas","2010-08",2010,8,28000,8885,19115,103.646468754236,"08",2010-08-01
"Arkansas","2010-09",2010,9,28000,7750,20250,113.286713286713,"09",2010-09-01
"Arkansas","2011-01",2011,1,25000,6394,18606,118.532203605785,"01",2011-01-01
"Arkansas","2011-10",2011,10,33000,6567,26433,133.611342785655,"10",2011-10-01
"Arkansas","2011-11",2011,11,31000,7206,23794,124.556352405381,"11",2011-11-01
"Arkansas","2011-12",2011,12,29000,7735,21265,115.775146318225,"12",2011-12-01
"Arkansas","2011-02",2011,2,24000,6339,17661,116.424404232176,"02",2011-02-01
"Arkansas","2011-03",2011,3,28000,11661,16339,82.3932830740526,"03",2011-03-01
"Arkansas","2011-04",2011,4,29000,7594,21406,116.991856588512,"04",2011-04-01
"Arkansas","2011-05",2011,5,31000,8957,22043,110.333608629276,"05",2011-05-01
"Arkansas","2011-06",2011,6,31000,8075,22925,117.338451695457,"06",2011-06-01
"Arkansas","2011-07",2011,7,34000,9185,24815,114.924163482691,"07",2011-07-01
"Arkansas","2011-08",2011,8,34000,7668,26332,126.389555534223,"08",2011-08-01
"Arkansas","2011-09",2011,9,34000,8728,25272,118.292454596518,"09",2011-09-01
"Arkansas","2012-01",2012,1,28000,7289,20711,117.379353339568,"01",2012-01-01
"Arkansas","2012-10",2012,10,32000,7139,24861,127.039525792688,"10",2012-10-01
"Arkansas","2012-11",2012,11,30000,11318,18682,90.4303209255046,"11",2012-11-01
"Arkansas","2012-12",2012,12,28000,6437,21563,125.231582309725,"12",2012-12-01
"Arkansas","2012-02",2012,2,28000,13386,14614,70.6229159619195,"02",2012-02-01
"Arkansas","2012-03",2012,3,29000,13600,15400,72.3004694835681,"03",2012-03-01
"Arkansas","2012-04",2012,4,29000,8127,20873,112.441080615186,"04",2012-04-01
"Arkansas","2012-05",2012,5,32000,12186,19814,89.6845154573847,"05",2012-05-01
"Arkansas","2012-06",2012,6,32000,12697,19303,86.3726872049578,"06",2012-06-01
"Arkansas","2012-07",2012,7,33000,7525,25475,125.724861196792,"07",2012-07-01
"Arkansas","2012-08",2012,8,33000,5652,27348,141.508848183794,"08",2012-08-01
"Arkansas","2012-09",2012,9,33000,6466,26534,134.465109207926,"09",2012-09-01
"Arkansas","2013-01",2013,1,28000,10834,17166,88.4070659731163,"01",2013-01-01
"Arkansas","2013-10",2013,10,34000,11807,22193,96.8978540397756,"10",2013-10-01
"Arkansas","2013-11",2013,11,32000,10839,21161,98.7931557692757,"11",2013-11-01
"Arkansas","2013-12",2013,12,30000,10249,19751,98.1440532684042,"12",2013-12-01
"Arkansas","2013-02",2013,2,29000,7970,21030,113.767919935083,"02",2013-02-01
"Arkansas","2013-03",2013,3,30000,10607,19393,95.515551505898,"03",2013-03-01
"Arkansas","2013-04",2013,4,31000,6794,24206,128.094406519553,"04",2013-04-01
"Arkansas","2013-05",2013,5,31000,9572,21428,105.629498176082,"05",2013-05-01
"Arkansas","2013-06",2013,6,32000,13684,18316,80.1856229752211,"06",2013-06-01
"Arkansas","2013-07",2013,7,31000,13550,17450,78.3389450056117,"07",2013-07-01
"Arkansas","2013-08",2013,8,31000,15214,15786,68.3169602285022,"08",2013-08-01
"Arkansas","2013-09",2013,9,32000,17295,14705,59.6612232477939,"09",2013-09-01
"Arkansas","2014-01",2014,1,28000,13404,14596,70.5052651917689,"01",2014-01-01
"Arkansas","2014-10",2014,10,47000,16577,30423,95.7044214102584,"10",2014-10-01
"Arkansas","2014-11",2014,11,42000,8596,33404,132.042058660764,"11",2014-11-01
"Arkansas","2014-12",2014,12,39000,10122,28878,117.57664590204,"12",2014-12-01
"Arkansas","2014-02",2014,2,31000,12898,18102,82.4730056038999,"02",2014-02-01
"Arkansas","2014-03",2014,3,33000,13347,19653,84.8080781927633,"03",2014-03-01
"Arkansas","2014-04",2014,4,35000,15505,19495,77.2002772002772,"04",2014-04-01
"Arkansas","2014-05",2014,5,37000,15361,21639,82.6531196883176,"05",2014-05-01
"Arkansas","2014-06",2014,6,40000,12845,27155,102.772258491816,"06",2014-06-01
"Arkansas","2014-07",2014,7,40000,10251,29749,118.401623848282,"07",2014-07-01
"Arkansas","2014-08",2014,8,43000,13291,29709,105.555062088078,"08",2014-08-01
"Arkansas","2014-09",2014,9,45000,14418,30582,102.938503483793,"09",2014-09-01
"Arkansas","2015-01",2015,1,38000,9153,28847,122.354887281827,"01",2015-01-01
"Arkansas","2015-10",2015,10,49000,24249,24751,67.5804447842291,"10",2015-10-01
"Arkansas","2015-11",2015,11,46000,13315,32685,110.208210402091,"11",2015-11-01
"Arkansas","2015-12",2015,12,43000,15635,27365,93.3401551974077,"12",2015-12-01
"Arkansas","2015-02",2015,2,42000,8192,33808,134.714695569015,"02",2015-02-01
"Arkansas","2015-03",2015,3,43000,10582,32418,121.003322011123,"03",2015-03-01
"Arkansas","2015-04",2015,4,46000,11739,34261,118.67541869447,"04",2015-04-01
"Arkansas","2015-05",2015,5,46000,13273,32727,110.428019502978,"05",2015-05-01
"Arkansas","2015-06",2015,6,47000,13645,33355,110.000824470278,"06",2015-06-01
"Arkansas","2015-07",2015,7,46000,15706,30294,98.1881826726736,"07",2015-07-01
"Arkansas","2015-08",2015,8,47000,13496,33504,110.76434805607,"08",2015-08-01
"Arkansas","2015-09",2015,9,49000,13029,35971,115.981234583824,"09",2015-09-01
"Arkansas","2016-01",2016,1,42000,22578,19422,60.1505156554864,"01",2016-01-01
"Arkansas","2016-10",2016,10,47000,20885,26115,76.9389408558592,"10",2016-10-01
"Arkansas","2016-11",2016,11,46000,17625,28375,89.1944990176817,"11",2016-11-01
"Arkansas","2016-12",2016,12,43000,13204,29796,106.028040708846,"12",2016-12-01
"Arkansas","2016-02",2016,2,45000,16427,28573,93.0307519494685,"02",2016-02-01
"Arkansas","2016-03",2016,3,48000,15696,32304,101.431801055011,"03",2016-03-01
"Arkansas","2016-04",2016,4,50000,19120,30880,89.3518518518518,"04",2016-04-01
"Arkansas","2016-05",2016,5,49000,17341,31659,95.4432402285163,"05",2016-05-01
"Arkansas","2016-06",2016,6,48000,17826,30174,91.6780603408987,"06",2016-06-01
"Arkansas","2016-07",2016,7,48000,22596,25404,71.970083290838,"07",2016-07-01
"Arkansas","2016-08",2016,8,49000,20264,28736,82.975282975283,"08",2016-08-01
"Arkansas","2016-09",2016,9,49000,25305,23695,63.777673104098,"09",2016-09-01
"Arkansas","2017-01",2017,1,44000,14703,29297,99.814319540739,"01",2017-01-01
"Arkansas","2017-10",2017,10,50000,10865,39135,128.596073276924,"10",2017-10-01
"Arkansas","2017-11",2017,11,46000,10228,35772,127.239097958313,"11",2017-11-01
"Arkansas","2017-12",2017,12,42000,8781,33219,130.832397944113,"12",2017-12-01
"Arkansas","2017-02",2017,2,46000,14858,31142,102.343159486017,"02",2017-02-01
"Arkansas","2017-03",2017,3,48000,18418,29582,89.0782619169502,"03",2017-03-01
"Arkansas","2017-04",2017,4,50000,13936,36064,112.812812812813,"04",2017-04-01
"Arkansas","2017-05",2017,5,51000,13365,37635,116.942437660219,"05",2017-05-01
"Arkansas","2017-06",2017,6,52000,15255,36745,109.270686194335,"06",2017-06-01
"Arkansas","2017-07",2017,7,52000,15624,36376,107.583106589377,"07",2017-07-01
"Arkansas","2017-08",2017,8,53000,13227,39773,120.111132921618,"08",2017-08-01
"Arkansas","2017-09",2017,9,54000,10098,43902,136.98399326032,"09",2017-09-01
"Arkansas","2018-01",2018,1,45000,13200,31800,109.278350515464,"01",2018-01-01
"Arkansas","2018-10",2018,10,63000,12033,50967,135.852225020991,"10",2018-10-01
"Arkansas","2018-11",2018,11,60000,9897,50103,143.362376067642,"11",2018-11-01
"Arkansas","2018-12",2018,12,56000,10182,45818,138.460608624702,"12",2018-12-01
"Arkansas","2018-02",2018,2,49000,13193,35807,115.148007010435,"02",2018-02-01
"Arkansas","2018-03",2018,3,53000,18227,34773,97.6399399104272,"03",2018-03-01
"Arkansas","2018-04",2018,4,54000,31581,22419,52.392470291303,"04",2018-04-01
"Arkansas","2018-05",2018,5,55000,23943,31057,78.6820870754848,"05",2018-05-01
"Arkansas","2018-06",2018,6,56000,14549,41451,117.509815872656,"06",2018-06-01
"Arkansas","2018-07",2018,7,60000,12981,47019,128.852715090229,"07",2018-07-01
"Arkansas","2018-08",2018,8,61000,11876,49124,134.815302705966,"08",2018-08-01
"Arkansas","2018-09",2018,9,64000,10627,53373,143.039382529111,"09",2018-09-01
"Arkansas","2019-01",2019,1,54000,10257,43743,136.150147065689,"01",2019-01-01
"Arkansas","2019-10",2019,10,70000,18393,51607,116.767164820744,"10",2019-10-01
"Arkansas","2019-11",2019,11,66000,17349,48651,116.740452794875,"11",2019-11-01
"Arkansas","2019-12",2019,12,59000,12482,46518,130.15304552195,"12",2019-12-01
"Arkansas","2019-02",2019,2,56000,8770,47230,145.839123050795,"02",2019-02-01
"Arkansas","2019-03",2019,3,60000,13466,46534,126.681730324232,"03",2019-03-01
"Arkansas","2019-04",2019,4,61000,13725,47275,126.530612244898,"04",2019-04-01
"Arkansas","2019-05",2019,5,61000,15033,45967,120.913287651415,"05",2019-05-01
"Arkansas","2019-06",2019,6,60000,12214,47786,132.345528567868,"06",2019-06-01
"Arkansas","2019-07",2019,7,62000,10335,51665,142.849243104998,"07",2019-07-01
"Arkansas","2019-08",2019,8,65000,13403,51597,131.619963521804,"08",2019-08-01
"Arkansas","2019-09",2019,9,69000,14361,54639,131.090078094073,"09",2019-09-01
"California","2010-01",2010,1,296000,28507,267493,164.861158619074,"01",2010-01-01
"California","2010-10",2010,10,360000,148760,211240,83.041119584873,"10",2010-10-01
"California","2010-11",2010,11,364000,140494,223506,88.6060091894056,"11",2010-11-01
"California","2010-12",2010,12,360000,150166,209834,82.261067966113,"12",2010-12-01
"California","2010-02",2010,2,317000,99537,217463,104.414733865179,"02",2010-02-01
"California","2010-03",2010,3,347000,90463,256537,117.283976016257,"03",2010-03-01
"California","2010-04",2010,4,373000,124623,248377,99.8253698080675,"04",2010-04-01
"California","2010-05",2010,5,382000,141304,240696,91.9908886612753,"05",2010-05-01
"California","2010-06",2010,6,365000,135639,229361,91.6273003102036,"06",2010-06-01
"California","2010-07",2010,7,338000,137594,200406,84.2760842230979,"07",2010-07-01
"California","2010-08",2010,8,338000,129363,208637,89.2826346972268,"08",2010-08-01
"California","2010-09",2010,9,350000,133811,216189,89.3691958223356,"09",2010-09-01
"California","2011-01",2011,1,345000,143976,201024,82.2224403651713,"01",2011-01-01
"California","2011-10",2011,10,427000,164466,262534,88.7739954621229,"10",2011-10-01
"California","2011-11",2011,11,412000,115235,296765,112.574089352945,"11",2011-11-01
"California","2011-12",2011,12,384000,114942,269058,107.851413591159,"12",2011-12-01
"California","2011-02",2011,2,354000,118872,235128,99.4467847535908,"02",2011-02-01
"California","2011-03",2011,3,375000,162587,212413,79.0246043896151,"03",2011-03-01
"California","2011-04",2011,4,398000,120494,277506,107.043090180407,"04",2011-04-01
"California","2011-05",2011,5,381000,159362,221638,82.0331555512786,"05",2011-05-01
"California","2011-06",2011,6,378000,144430,233570,89.4167639683785,"06",2011-06-01
"California","2011-07",2011,7,382000,147708,234292,88.4608123720993,"07",2011-07-01
"California","2011-08",2011,8,397000,139283,257717,96.1123138343002,"08",2011-08-01
"California","2011-09",2011,9,412000,159356,252644,88.4366314521944,"09",2011-09-01
"California","2012-01",2012,1,359000,151318,207682,81.3931705328834,"01",2012-01-01
"California","2012-10",2012,10,380000,122030,257970,102.770750751947,"10",2012-10-01
"California","2012-11",2012,11,380000,161459,218541,80.7230094984108,"11",2012-11-01
"California","2012-12",2012,12,363000,125724,237276,97.1002037960076,"12",2012-12-01
"California","2012-02",2012,2,358000,153323,204677,80.0578108162551,"02",2012-02-01
"California","2012-03",2012,3,375000,178838,196162,70.8373206605542,"03",2012-03-01
"California","2012-04",2012,4,374000,179896,194104,70.0868032988142,"04",2012-04-01
"California","2012-05",2012,5,383000,172760,210240,75.6585576507845,"05",2012-05-01
"California","2012-06",2012,6,382000,159696,222304,82.0770321361059,"06",2012-06-01
"California","2012-07",2012,7,368000,156355,211645,80.7258441323149,"07",2012-07-01
"California","2012-08",2012,8,368000,151602,216398,83.2937517561518,"08",2012-08-01
"California","2012-09",2012,9,371000,128080,242920,97.3471186984051,"09",2012-09-01
"California","2013-01",2013,1,361000,158130,202870,78.1576868992353,"01",2013-01-01
"California","2013-10",2013,10,486000,209922,276078,79.3416503573676,"10",2013-10-01
"California","2013-11",2013,11,465000,185406,279594,85.9752216307968,"11",2013-11-01
"California","2013-12",2013,12,438000,160659,277341,92.6540818729861,"12",2013-12-01
"California","2013-02",2013,2,370000,136371,233629,92.2758214826678,"02",2013-02-01
"California","2013-03",2013,3,409000,132715,276285,102.003821197493,"03",2013-03-01
"California","2013-04",2013,4,440000,113448,326552,118.006389037452,"04",2013-04-01
"California","2013-05",2013,5,457000,162964,294036,94.8558303385358,"05",2013-05-01
"California","2013-06",2013,6,451000,230214,220786,64.8213336778164,"06",2013-06-01
"California","2013-07",2013,7,460000,244314,215686,61.2471142132628,"07",2013-07-01
"California","2013-08",2013,8,472000,254308,217692,59.9448167994845,"08",2013-08-01
"California","2013-09",2013,9,482000,227963,254037,71.5634476726252,"09",2013-09-01
"California","2014-01",2014,1,420000,198856,221144,71.4686453714596,"01",2014-01-01
"California","2014-10",2014,10,572000,200809,371191,96.0628046516021,"10",2014-10-01
"California","2014-11",2014,11,535000,146876,388124,113.84005303017,"11",2014-11-01
"California","2014-12",2014,12,519000,157270,361730,106.977982166886,"12",2014-12-01
"California","2014-02",2014,2,449000,177844,271156,86.5146671261111,"02",2014-02-01
"California","2014-03",2014,3,472000,193096,278904,83.868794880739,"03",2014-03-01
"California","2014-04",2014,4,512000,203811,308189,86.1090427501114,"04",2014-04-01
"California","2014-05",2014,5,505000,201545,303455,85.898279656639,"05",2014-05-01
"California","2014-06",2014,6,526000,168647,357353,102.88765372916,"06",2014-06-01
"California","2014-07",2014,7,515000,150497,364503,109.543093357295,"07",2014-07-01
"California","2014-08",2014,8,557000,183596,373404,100.838783898374,"08",2014-08-01
"California","2014-09",2014,9,555000,180883,374117,101.678391809568,"09",2014-09-01
"California","2015-01",2015,1,518000,164940,353060,103.39414882713,"01",2015-01-01
"California","2015-10",2015,10,602000,255465,346535,80.8277888893424,"10",2015-10-01
"California","2015-11",2015,11,587000,226155,360845,88.7518369806494,"11",2015-11-01
"California","2015-12",2015,12,569000,195205,373795,97.8258451593486,"12",2015-12-01
"California","2015-02",2015,2,548000,144797,403203,116.398598723724,"02",2015-02-01
"California","2015-03",2015,3,589000,199668,389332,98.7315321529465,"03",2015-03-01
"California","2015-04",2015,4,609000,200075,408925,101.084571887649,"04",2015-04-01
"California","2015-05",2015,5,605000,225628,379372,91.345825086561,"05",2015-05-01
"California","2015-06",2015,6,592000,241919,350081,83.9604326079631,"06",2015-06-01
"California","2015-07",2015,7,601000,250029,350971,82.4815605578658,"07",2015-07-01
"California","2015-08",2015,8,596000,252321,343679,81.0256966407763,"08",2015-08-01
"California","2015-09",2015,9,606000,248783,357217,83.5807450545928,"09",2015-09-01
"California","2016-01",2016,1,566000,261887,304113,73.4672727075072,"01",2016-01-01
"California","2016-10",2016,10,690000,243530,446470,95.651987616895,"10",2016-10-01
"California","2016-11",2016,11,701000,211307,489693,107.35267842952,"11",2016-11-01
"California","2016-12",2016,12,666000,201066,464934,107.243047242078,"12",2016-12-01
"California","2016-02",2016,2,602000,233117,368883,88.3428310045179,"02",2016-02-01
"California","2016-03",2016,3,648000,238729,409271,92.3102774353833,"03",2016-03-01
"California","2016-04",2016,4,669000,224095,444905,99.632177987784,"04",2016-04-01
"California","2016-05",2016,5,662000,218316,443684,100.801075977263,"05",2016-05-01
"California","2016-06",2016,6,641000,253749,387251,86.560812026613,"06",2016-06-01
"California","2016-07",2016,7,614000,274385,339615,76.4567164011099,"07",2016-07-01
"California","2016-08",2016,8,631000,247812,383188,87.205909796407,"08",2016-08-01
"California","2016-09",2016,9,658000,264165,393835,85.4152998649916,"09",2016-09-01
"California","2017-01",2017,1,630000,225732,404268,94.4847218521687,"01",2017-01-01
"California","2017-10",2017,10,720000,202542,517458,112.180908836671,"10",2017-10-01
"California","2017-11",2017,11,682000,177305,504695,117.465859037245,"11",2017-11-01
"California","2017-12",2017,12,672000,146031,525969,128.593904142997,"12",2017-12-01
"California","2017-02",2017,2,599000,239677,359323,85.688053923024,"02",2017-02-01
"California","2017-03",2017,3,614000,264933,349067,79.4297176235276,"03",2017-03-01
"California","2017-04",2017,4,637000,235891,401109,91.9035710071475,"04",2017-04-01
"California","2017-05",2017,5,652000,248309,403691,89.6783215540442,"05",2017-05-01
"California","2017-06",2017,6,674000,247791,426209,92.4741074712164,"06",2017-06-01
"California","2017-07",2017,7,684000,235144,448856,97.6682652554986,"07",2017-07-01
"California","2017-08",2017,8,713000,229399,483601,102.631900076295,"08",2017-08-01
"California","2017-09",2017,9,708000,197881,510119,112.623843529117,"09",2017-09-01
"California","2018-01",2018,1,664000,178624,485376,115.205833206745,"01",2018-01-01
"California","2018-10",2018,10,790000,426705,363295,59.717844506269,"10",2018-10-01
"California","2018-11",2018,11,764000,417740,346260,58.6017228832061,"11",2018-11-01
"California","2018-12",2018,12,728000,359785,368215,67.6999590911807,"12",2018-12-01
"California","2018-02",2018,2,696000,188443,507557,114.774383425501,"02",2018-02-01
"California","2018-03",2018,3,725000,256981,468019,95.3213962388274,"03",2018-03-01
"California","2018-04",2018,4,747000,289925,457075,88.1597029679099,"04",2018-04-01
"California","2018-05",2018,5,757000,442815,314185,52.3722407204444,"05",2018-05-01
"California","2018-06",2018,6,759000,306429,452571,84.9556375882391,"06",2018-06-01
"California","2018-07",2018,7,763000,420516,342484,57.8756856688038,"07",2018-07-01
"California","2018-08",2018,8,787000,376452,410548,70.5741190869929,"08",2018-08-01
"California","2018-09",2018,9,8e+05,352538,447462,77.6481122531318,"09",2018-09-01
"California","2019-01",2019,1,711000,345256,365744,69.2529083858459,"01",2019-01-01
"California","2019-10",2019,10,778000,468176,309824,49.7239555247413,"10",2019-10-01
"California","2019-11",2019,11,756000,416921,339079,57.8178752021662,"11",2019-11-01
"California","2019-12",2019,12,739000,408771,330229,57.5426631270524,"12",2019-12-01
"California","2019-02",2019,2,692000,346038,345962,66.656904660523,"02",2019-02-01
"California","2019-03",2019,3,721000,437983,283017,48.8388526837753,"03",2019-03-01
"California","2019-04",2019,4,743000,371224,371776,66.7327216071454,"04",2019-04-01
"California","2019-05",2019,5,758000,464174,293826,48.0825152556019,"05",2019-05-01
"California","2019-06",2019,6,764000,371023,392977,69.2456452424312,"06",2019-06-01
"California","2019-07",2019,7,763000,361991,401009,71.2910592173626,"07",2019-07-01
"California","2019-08",2019,8,778000,464182,313818,50.5268954146816,"08",2019-08-01
"California","2019-09",2019,9,762000,466019,295981,48.204628755744,"09",2019-09-01
"Colorado","2010-01",2010,1,42000,4575,37425,160.708534621578,"01",2010-01-01
"Colorado","2010-10",2010,10,65000,32015,32985,67.9997938463124,"10",2010-10-01
"Colorado","2010-11",2010,11,63000,23230,39770,92.2416792299664,"11",2010-11-01
"Colorado","2010-12",2010,12,64000,28555,35445,76.5922964723678,"12",2010-12-01
"Colorado","2010-02",2010,2,46000,15364,30636,99.8500749625187,"02",2010-02-01
"Colorado","2010-03",2010,3,52000,17896,34104,97.5849834039144,"03",2010-03-01
"Colorado","2010-04",2010,4,55000,19291,35709,96.1327751679207,"04",2010-04-01
"Colorado","2010-05",2010,5,58000,23297,34703,85.3733840117102,"05",2010-05-01
"Colorado","2010-06",2010,6,56000,22912,33088,83.860502838605,"06",2010-06-01
"Colorado","2010-07",2010,7,57000,26807,30193,72.0536470700538,"07",2010-07-01
"Colorado","2010-08",2010,8,59000,26372,32628,76.4372393759078,"08",2010-08-01
"Colorado","2010-09",2010,9,59000,26266,32734,76.7808974268759,"09",2010-09-01
"Colorado","2011-01",2011,1,55000,32282,22718,52.0565523246488,"01",2011-01-01
"Colorado","2011-10",2011,10,62000,31858,30142,64.2289415926186,"10",2011-10-01
"Colorado","2011-11",2011,11,59000,26105,32895,77.3045061982257,"11",2011-11-01
"Colorado","2011-12",2011,12,54000,25082,28918,73.1342151184846,"12",2011-12-01
"Colorado","2011-02",2011,2,53000,29366,23634,57.3877570842338,"02",2011-02-01
"Colorado","2011-03",2011,3,54000,35098,18902,42.4296841679948,"03",2011-03-01
"Colorado","2011-04",2011,4,57000,25000,32000,78.0487804878049,"04",2011-04-01
"Colorado","2011-05",2011,5,59000,29170,29830,67.6647385732109,"05",2011-05-01
"Colorado","2011-06",2011,6,61000,27364,33636,76.1305509030827,"06",2011-06-01
"Colorado","2011-07",2011,7,62000,32347,29653,62.8594443914486,"07",2011-07-01
"Colorado","2011-08",2011,8,62000,29672,32328,70.5297146347849,"08",2011-08-01
"Colorado","2011-09",2011,9,61000,30411,30589,66.9262998982617,"09",2011-09-01
"Colorado","2012-01",2012,1,50000,36082,13918,32.3366092795242,"01",2012-01-01
"Colorado","2012-10",2012,10,67000,25828,41172,88.7059938811566,"10",2012-10-01
"Colorado","2012-11",2012,11,65000,22780,42220,96.1950330371383,"11",2012-11-01
"Colorado","2012-12",2012,12,63000,34169,28831,59.3419712048081,"12",2012-12-01
"Colorado","2012-02",2012,2,49000,39941,9059,20.3708076140363,"02",2012-02-01
"Colorado","2012-03",2012,3,53000,39901,13099,28.1999117339964,"03",2012-03-01
"Colorado","2012-04",2012,4,57000,32553,24447,54.5978359183947,"04",2012-04-01
"Colorado","2012-05",2012,5,61000,37534,23466,47.6302596058213,"05",2012-05-01
"Colorado","2012-06",2012,6,64000,34641,29359,59.5269715432731,"06",2012-06-01
"Colorado","2012-07",2012,7,65000,23155,41845,94.9350575690545,"07",2012-07-01
"Colorado","2012-08",2012,8,66000,21236,44764,102.627355678848,"08",2012-08-01
"Colorado","2012-09",2012,9,66000,22259,43741,99.1196365243205,"09",2012-09-01
"Colorado","2013-01",2013,1,61000,32057,28943,62.2048851779017,"01",2013-01-01
"Colorado","2013-10",2013,10,74000,36464,37536,67.9606025492468,"10",2013-10-01
"Colorado","2013-11",2013,11,74000,35891,38109,69.3578182016726,"11",2013-11-01
"Colorado","2013-12",2013,12,75000,34897,40103,72.9828839731749,"12",2013-12-01
"Colorado","2013-02",2013,2,65000,28304,36696,78.6590071165223,"02",2013-02-01
"Colorado","2013-03",2013,3,67000,29320,37680,78.2392026578073,"03",2013-03-01
"Colorado","2013-04",2013,4,74000,24498,49502,100.513716014538,"04",2013-04-01
"Colorado","2013-05",2013,5,76000,32279,43721,80.7561946453144,"05",2013-05-01
"Colorado","2013-06",2013,6,78000,43810,34190,56.136606189968,"06",2013-06-01
"Colorado","2013-07",2013,7,73000,46348,26652,44.6626671582264,"07",2013-07-01
"Colorado","2013-08",2013,8,71000,42940,28060,49.2539933298227,"08",2013-08-01
"Colorado","2013-09",2013,9,68000,38530,29470,55.3271378954285,"09",2013-09-01
"Colorado","2014-01",2014,1,70000,42687,27313,48.4758667814389,"01",2014-01-01
"Colorado","2014-10",2014,10,108000,45568,62432,81.3086059595749,"10",2014-10-01
"Colorado","2014-11",2014,11,101000,34938,66062,97.1943091703571,"11",2014-11-01
"Colorado","2014-12",2014,12,98000,42525,55475,78.9539227895392,"12",2014-12-01
"Colorado","2014-02",2014,2,75000,38343,36657,64.6833064238639,"02",2014-02-01
"Colorado","2014-03",2014,3,79000,45528,33472,53.7581909289477,"03",2014-03-01
"Colorado","2014-04",2014,4,87000,43352,43648,66.9694366024303,"04",2014-04-01
"Colorado","2014-05",2014,5,90000,42018,47982,72.6900877153115,"05",2014-05-01
"Colorado","2014-06",2014,6,103000,41511,61489,85.0994041976043,"06",2014-06-01
"Colorado","2014-07",2014,7,107000,31930,75070,108.068811631757,"07",2014-07-01
"Colorado","2014-08",2014,8,113000,47630,65370,81.3920189254809,"08",2014-08-01
"Colorado","2014-09",2014,9,107000,41300,65700,88.6041807147674,"09",2014-09-01
"Colorado","2015-01",2015,1,91000,36487,54513,85.5193078509966,"01",2015-01-01
"Colorado","2015-10",2015,10,108000,41614,66386,88.7430320691914,"10",2015-10-01
"Colorado","2015-11",2015,11,104000,39274,64726,90.3527506735346,"11",2015-11-01
"Colorado","2015-12",2015,12,102000,38142,63858,91.1332791026245,"12",2015-12-01
"Colorado","2015-02",2015,2,98000,32884,65116,99.5018489654962,"02",2015-02-01
"Colorado","2015-03",2015,3,105000,47182,57818,75.9853333508562,"03",2015-03-01
"Colorado","2015-04",2015,4,119000,42947,76053,93.9233205925395,"04",2015-04-01
"Colorado","2015-05",2015,5,118000,48413,69587,83.6316874282658,"05",2015-05-01
"Colorado","2015-06",2015,6,117000,48332,68668,83.0667989257978,"06",2015-06-01
"Colorado","2015-07",2015,7,114000,49298,64702,79.2440813727051,"07",2015-07-01
"Colorado","2015-08",2015,8,113000,48927,64073,79.1381301450654,"08",2015-08-01
"Colorado","2015-09",2015,9,110000,43494,66506,86.6561559409488,"09",2015-09-01
"Colorado","2016-01",2016,1,98000,47400,50600,69.6011004126547,"01",2016-01-01
"Colorado","2016-10",2016,10,120000,47676,72324,86.2663708580834,"10",2016-10-01
"Colorado","2016-11",2016,11,113000,42759,70241,90.1918990234914,"11",2016-11-01
"Colorado","2016-12",2016,12,112000,39130,72870,96.4335340435387,"12",2016-12-01
"Colorado","2016-02",2016,2,102000,42196,59804,82.9482093816749,"02",2016-02-01
"Colorado","2016-03",2016,3,109000,49500,59500,75.0788643533123,"03",2016-03-01
"Colorado","2016-04",2016,4,119000,43641,75359,92.6691301701293,"04",2016-04-01
"Colorado","2016-05",2016,5,126000,39124,86876,105.225164119086,"05",2016-05-01
"Colorado","2016-06",2016,6,130000,47471,82529,93.0056178192493,"06",2016-06-01
"Colorado","2016-07",2016,7,135000,50730,84270,90.7446293005977,"07",2016-07-01
"Colorado","2016-08",2016,8,132000,46403,85597,95.9591486690246,"08",2016-08-01
"Colorado","2016-09",2016,9,128000,56112,71888,78.0915964195707,"09",2016-09-01
"Colorado","2017-01",2017,1,109000,44706,64294,83.6584128140736,"01",2017-01-01
"Colorado","2017-10",2017,10,137000,40241,96759,109.183541054271,"10",2017-10-01
"Colorado","2017-11",2017,11,129000,36130,92870,112.48107551626,"11",2017-11-01
"Colorado","2017-12",2017,12,126000,31201,94799,120.608647527687,"12",2017-12-01
"Colorado","2017-02",2017,2,115000,45635,69365,86.3634948796962,"02",2017-02-01
"Colorado","2017-03",2017,3,109000,51632,57368,71.4278599531849,"03",2017-03-01
"Colorado","2017-04",2017,4,115000,48864,66136,80.7205975687155,"04",2017-04-01
"Colorado","2017-05",2017,5,116000,49236,66764,80.8104771357331,"05",2017-05-01
"Colorado","2017-06",2017,6,124000,50665,73335,83.9721753070163,"06",2017-06-01
"Colorado","2017-07",2017,7,121000,53168,67832,77.8926094345689,"07",2017-07-01
"Colorado","2017-08",2017,8,127000,48366,78634,89.6798695300115,"08",2017-08-01
"Colorado","2017-09",2017,9,128000,43530,84470,98.490060047805,"09",2017-09-01
"Colorado","2018-01",2018,1,118000,38907,79093,100.815132530735,"01",2018-01-01
"Colorado","2018-10",2018,10,150000,78514,71486,62.5659696998871,"10",2018-10-01
"Colorado","2018-11",2018,11,144000,81542,62458,55.3848063775261,"11",2018-11-01
"Colorado","2018-12",2018,12,140000,69706,70294,67.0405233994259,"12",2018-12-01
"Colorado","2018-02",2018,2,130000,42441,87559,101.552415028908,"02",2018-02-01
"Colorado","2018-03",2018,3,143000,53570,89430,90.9904868494684,"03",2018-03-01
"Colorado","2018-04",2018,4,150000,59545,90455,86.3346775155695,"04",2018-04-01
"Colorado","2018-05",2018,5,143000,88273,54727,47.3267523662511,"05",2018-05-01
"Colorado","2018-06",2018,6,140000,64536,75464,73.7904329800133,"06",2018-06-01
"Colorado","2018-07",2018,7,135000,87842,47158,42.3241579235512,"07",2018-07-01
"Colorado","2018-08",2018,8,142000,78940,63060,57.0833710509641,"08",2018-08-01
"Colorado","2018-09",2018,9,145000,68611,76389,71.5215976705319,"09",2018-09-01
"Colorado","2019-01",2019,1,139000,64532,74468,73.1757168405951,"01",2019-01-01
"Colorado","2019-10",2019,10,143000,88854,54146,46.7069793922037,"10",2019-10-01
"Colorado","2019-11",2019,11,130000,85208,44792,41.6267053269395,"11",2019-11-01
"Colorado","2019-12",2019,12,117000,84273,32727,32.5200101354876,"12",2019-12-01
"Colorado","2019-02",2019,2,142000,64991,77009,74.408066051181,"02",2019-02-01
"Colorado","2019-03",2019,3,149000,75725,73275,65.2130381577484,"03",2019-03-01
"Colorado","2019-04",2019,4,153000,71299,81701,72.8500795812732,"04",2019-04-01
"Colorado","2019-05",2019,5,154000,91489,62511,50.9277401431429,"05",2019-05-01
"Colorado","2019-06",2019,6,151000,66714,84286,77.4281856012934,"06",2019-06-01
"Colorado","2019-07",2019,7,151000,71183,79817,71.8479811686763,"07",2019-07-01
"Colorado","2019-08",2019,8,153000,85495,67505,56.6091532317239,"08",2019-08-01
"Colorado","2019-09",2019,9,151000,94372,56628,46.1568557129583,"09",2019-09-01
"Connecticut","2010-01",2010,1,33000,5271,27729,144.908677588775,"01",2010-01-01
"Connecticut","2010-10",2010,10,42000,20147,21853,70.3268057991536,"10",2010-10-01
"Connecticut","2010-11",2010,11,38000,18473,19527,69.155171497884,"11",2010-11-01
"Connecticut","2010-12",2010,12,34000,19723,14277,53.1504197457327,"12",2010-12-01
"Connecticut","2010-02",2010,2,34000,13502,20498,86.3037345795967,"02",2010-02-01
"Connecticut","2010-03",2010,3,34000,12806,21194,90.5610391830107,"03",2010-03-01
"Connecticut","2010-04",2010,4,45000,14710,30290,101.457042371462,"04",2010-04-01
"Connecticut","2010-05",2010,5,48000,17619,30381,92.5981804050656,"05",2010-05-01
"Connecticut","2010-06",2010,6,49000,15505,33495,103.852414541508,"06",2010-06-01
"Connecticut","2010-07",2010,7,41000,18583,22417,75.2462950841683,"07",2010-07-01
"Connecticut","2010-08",2010,8,42000,18775,23225,76.4294529000411,"08",2010-08-01
"Connecticut","2010-09",2010,9,42000,18709,23291,76.729974138925,"09",2010-09-01
"Connecticut","2011-01",2011,1,34000,17910,16090,61.9919090733963,"01",2011-01-01
"Connecticut","2011-10",2011,10,39000,17744,21256,74.9189341604399,"10",2011-10-01
"Connecticut","2011-11",2011,11,39000,15656,23344,85.4215456674473,"11",2011-11-01
"Connecticut","2011-12",2011,12,36000,17737,18263,67.9717885255969,"12",2011-12-01
"Connecticut","2011-02",2011,2,33000,15985,17015,69.4702459936715,"02",2011-02-01
"Connecticut","2011-03",2011,3,35000,23141,11859,40.7939319929138,"03",2011-03-01
"Connecticut","2011-04",2011,4,37000,18621,18379,66.0865500440481,"04",2011-04-01
"Connecticut","2011-05",2011,5,38000,19676,18324,63.541160968167,"05",2011-05-01
"Connecticut","2011-06",2011,6,38000,17842,20158,72.1965545646646,"06",2011-06-01
"Connecticut","2011-07",2011,7,37000,21462,15538,53.1558961376621,"07",2011-07-01
"Connecticut","2011-08",2011,8,36000,21490,14510,50.4783440598365,"08",2011-08-01
"Connecticut","2011-09",2011,9,39000,18959,20041,69.1557825359306,"09",2011-09-01
"Connecticut","2012-01",2012,1,37000,18485,18515,66.7387582229431,"01",2012-01-01
"Connecticut","2012-10",2012,10,42000,15633,26367,91.4996616521784,"10",2012-10-01
"Connecticut","2012-11",2012,11,41000,23943,17057,52.5291409389773,"11",2012-11-01
"Connecticut","2012-12",2012,12,40000,13847,26153,97.138187828477,"12",2012-12-01
"Connecticut","2012-02",2012,2,38000,24050,13950,44.9637389202256,"02",2012-02-01
"Connecticut","2012-03",2012,3,41000,19318,21682,71.8923041214894,"03",2012-03-01
"Connecticut","2012-04",2012,4,42000,19096,22904,74.9770852428964,"04",2012-04-01
"Connecticut","2012-05",2012,5,43000,30901,12099,32.7438059024912,"05",2012-05-01
"Connecticut","2012-06",2012,6,41000,17413,23587,80.759419992125,"06",2012-06-01
"Connecticut","2012-07",2012,7,40000,15672,24328,87.3976145997988,"07",2012-07-01
"Connecticut","2012-08",2012,8,40000,13670,26330,98.1181293087386,"08",2012-08-01
"Connecticut","2012-09",2012,9,42000,13227,28773,104.199033081645,"09",2012-09-01
"Connecticut","2013-01",2013,1,40000,23368,16632,52.4933720489837,"01",2013-01-01
"Connecticut","2013-10",2013,10,43000,26010,16990,49.2392406897551,"10",2013-10-01
"Connecticut","2013-11",2013,11,42000,21821,20179,63.2362388555491,"11",2013-11-01
"Connecticut","2013-12",2013,12,39000,23786,15214,48.4630331602587,"12",2013-12-01
"Connecticut","2013-02",2013,2,39000,16839,22161,79.3746306345028,"02",2013-02-01
"Connecticut","2013-03",2013,3,41000,18203,22797,77.012989206628,"03",2013-03-01
"Connecticut","2013-04",2013,4,41000,13048,27952,103.433984606276,"04",2013-04-01
"Connecticut","2013-05",2013,5,42000,17913,24087,80.4065895548545,"05",2013-05-01
"Connecticut","2013-06",2013,6,42000,28889,13111,36.9902241532537,"06",2013-06-01
"Connecticut","2013-07",2013,7,39000,28071,10929,32.5893456188218,"07",2013-07-01
"Connecticut","2013-08",2013,8,42000,26243,15757,46.1790952918248,"08",2013-08-01
"Connecticut","2013-09",2013,9,42000,27183,14817,42.8342222800399,"09",2013-09-01
"Connecticut","2014-01",2014,1,40000,23383,16617,52.4336178470568,"01",2014-01-01
"Connecticut","2014-10",2014,10,54000,29620,24380,58.3114087538866,"10",2014-10-01
"Connecticut","2014-11",2014,11,51000,18645,32355,92.9140641826405,"11",2014-11-01
"Connecticut","2014-12",2014,12,48000,19540,28460,84.2759846017175,"12",2014-12-01
"Connecticut","2014-02",2014,2,40000,22390,17610,56.4513543837153,"02",2014-02-01
"Connecticut","2014-03",2014,3,43000,23903,19097,57.0886208391253,"03",2014-03-01
"Connecticut","2014-04",2014,4,47000,22702,24298,69.7196637112278,"04",2014-04-01
"Connecticut","2014-05",2014,5,50000,22977,27023,74.0589500801622,"05",2014-05-01
"Connecticut","2014-06",2014,6,51000,18056,32944,95.4124189063948,"06",2014-06-01
"Connecticut","2014-07",2014,7,49000,18113,30887,92.0447603295934,"07",2014-07-01
"Connecticut","2014-08",2014,8,51000,22270,28730,78.4222737819025,"08",2014-08-01
"Connecticut","2014-09",2014,9,53000,28256,24744,60.9038101801713,"09",2014-09-01
"Connecticut","2015-01",2015,1,48000,17321,30679,93.9330383796941,"01",2015-01-01
"Connecticut","2015-10",2015,10,57000,24400,32600,80.0982800982801,"10",2015-10-01
"Connecticut","2015-11",2015,11,58000,20115,37885,96.9980157460155,"11",2015-11-01
"Connecticut","2015-12",2015,12,57000,20088,36912,95.7658779576588,"12",2015-12-01
"Connecticut","2015-02",2015,2,48000,17120,30880,94.8402948402948,"02",2015-02-01
"Connecticut","2015-03",2015,3,48000,20248,27752,81.3269253311452,"03",2015-03-01
"Connecticut","2015-04",2015,4,47000,19604,27396,82.2653294096451,"04",2015-04-01
"Connecticut","2015-05",2015,5,50000,21876,28124,78.2569981635038,"05",2015-05-01
"Connecticut","2015-06",2015,6,51000,21441,29559,81.6084813848511,"06",2015-06-01
"Connecticut","2015-07",2015,7,54000,25664,28336,71.1387828881302,"07",2015-07-01
"Connecticut","2015-08",2015,8,53000,23850,29150,75.8620689655172,"08",2015-08-01
"Connecticut","2015-09",2015,9,57000,22668,34332,86.1876788672993,"09",2015-09-01
"Connecticut","2016-01",2016,1,58000,27496,30504,71.3577243379807,"01",2016-01-01
"Connecticut","2016-10",2016,10,59000,31041,27959,62.1028198265235,"10",2016-10-01
"Connecticut","2016-11",2016,11,58000,27136,30864,72.5051682014659,"11",2016-11-01
"Connecticut","2016-12",2016,12,57000,23935,33065,81.7075430901341,"12",2016-12-01
"Connecticut","2016-02",2016,2,56000,22603,33397,84.9764003918426,"02",2016-02-01
"Connecticut","2016-03",2016,3,57000,31266,25734,58.3101080823873,"03",2016-03-01
"Connecticut","2016-04",2016,4,57000,33095,23905,53.0662078916699,"04",2016-04-01
"Connecticut","2016-05",2016,5,59000,37524,21476,44.4987775061125,"05",2016-05-01
"Connecticut","2016-06",2016,6,60000,47174,12826,23.9349095862803,"06",2016-06-01
"Connecticut","2016-07",2016,7,62000,26048,35952,81.6645466109395,"07",2016-07-01
"Connecticut","2016-08",2016,8,62000,26436,35564,80.4287846578317,"08",2016-08-01
"Connecticut","2016-09",2016,9,62000,30975,31025,66.7383705297123,"09",2016-09-01
"Connecticut","2017-01",2017,1,61000,24218,36782,86.3244854373489,"01",2017-01-01
"Connecticut","2017-10",2017,10,69000,23440,45560,98.572046733016,"10",2017-10-01
"Connecticut","2017-11",2017,11,67000,22350,44650,99.9440402909905,"11",2017-11-01
"Connecticut","2017-12",2017,12,63000,19105,43895,106.924060654041,"12",2017-12-01
"Connecticut","2017-02",2017,2,63000,27436,35564,78.6500950948737,"02",2017-02-01
"Connecticut","2017-03",2017,3,65000,27949,37051,79.7232891155365,"03",2017-03-01
"Connecticut","2017-04",2017,4,73000,27093,45907,91.728692316146,"04",2017-04-01
"Connecticut","2017-05",2017,5,73000,26034,46966,94.848233939859,"05",2017-05-01
"Connecticut","2017-06",2017,6,73000,24732,48268,98.7762452420906,"06",2017-06-01
"Connecticut","2017-07",2017,7,65000,26071,38929,85.4915395680293,"07",2017-07-01
"Connecticut","2017-08",2017,8,67000,26936,40064,85.3006302163175,"08",2017-08-01
"Connecticut","2017-09",2017,9,68000,23740,44260,96.4900806627425,"09",2017-09-01
"Connecticut","2018-01",2018,1,62000,24639,37361,86.2452244370318,"01",2018-01-01
"Connecticut","2018-10",2018,10,75000,21422,53578,111.132314202153,"10",2018-10-01
"Connecticut","2018-11",2018,11,70000,20206,49794,110.400638538456,"11",2018-11-01
"Connecticut","2018-12",2018,12,64000,20258,43742,103.828716561039,"12",2018-12-01
"Connecticut","2018-02",2018,2,59000,24721,34279,81.8886539816772,"02",2018-02-01
"Connecticut","2018-03",2018,3,61000,32426,28574,61.1692676556847,"03",2018-03-01
"Connecticut","2018-04",2018,4,63000,27980,35020,76.9839525170367,"04",2018-04-01
"Connecticut","2018-05",2018,5,68000,36017,31983,61.4957170462521,"05",2018-05-01
"Connecticut","2018-06",2018,6,70000,25348,44652,93.6611150732055,"06",2018-06-01
"Connecticut","2018-07",2018,7,70000,27548,42452,87.0381760774183,"07",2018-07-01
"Connecticut","2018-08",2018,8,72000,25004,46996,96.8949734031586,"08",2018-08-01
"Connecticut","2018-09",2018,9,74000,21907,52093,108.6323208942,"09",2018-09-01
"Connecticut","2019-01",2019,1,63000,20482,42518,101.861479121248,"01",2019-01-01
"Connecticut","2019-10",2019,10,74000,34167,39833,73.6509286566143,"10",2019-10-01
"Connecticut","2019-11",2019,11,70000,34347,35653,68.3354576557064,"11",2019-11-01
"Connecticut","2019-12",2019,12,65000,27232,37768,81.8978228814294,"12",2019-12-01
"Connecticut","2019-02",2019,2,63000,19582,43418,105.151243612409,"02",2019-02-01
"Connecticut","2019-03",2019,3,67000,24618,42382,92.5189373267262,"03",2019-03-01
"Connecticut","2019-04",2019,4,66000,21759,44241,100.82384712679,"04",2019-04-01
"Connecticut","2019-05",2019,5,71000,23657,47343,100.030636931236,"05",2019-05-01
"Connecticut","2019-06",2019,6,70000,18572,51428,116.126992729079,"06",2019-06-01
"Connecticut","2019-07",2019,7,70000,18547,51453,116.21624673902,"07",2019-07-01
"Connecticut","2019-08",2019,8,70000,26781,43219,89.3129849867226,"08",2019-08-01
"Connecticut","2019-09",2019,9,70000,31506,38494,75.8457628120505,"09",2019-09-01
"Delaware","2010-01",2010,1,8000,1366,6634,141.661328208413,"01",2010-01-01
"Delaware","2010-10",2010,10,10000,5634,4366,55.8526288857618,"10",2010-10-01
"Delaware","2010-11",2010,11,10000,5013,4987,66.4357556784121,"11",2010-11-01
"Delaware","2010-12",2010,12,10000,5096,4904,64.9708532061473,"12",2010-12-01
"Delaware","2010-02",2010,2,8000,3453,4547,79.4027765650921,"02",2010-02-01
"Delaware","2010-03",2010,3,9000,3644,5356,84.7200253084467,"03",2010-03-01
"Delaware","2010-04",2010,4,9000,3888,5112,79.3296089385475,"04",2010-04-01
"Delaware","2010-05",2010,5,10000,5122,4878,64.515275757175,"05",2010-05-01
"Delaware","2010-06",2010,6,11000,4190,6810,89.6642527978934,"06",2010-06-01
"Delaware","2010-07",2010,7,11000,4979,6021,75.3614118530571,"07",2010-07-01
"Delaware","2010-08",2010,8,10000,5519,4481,57.7485662736001,"08",2010-08-01
"Delaware","2010-09",2010,9,11000,5216,5784,71.3369511593488,"09",2010-09-01
"Delaware","2011-01",2011,1,9000,4906,4094,58.8810585358838,"01",2011-01-01
"Delaware","2011-10",2011,10,12000,4811,7189,85.5273332936768,"10",2011-10-01
"Delaware","2011-11",2011,11,13000,3109,9891,122.800918741076,"11",2011-11-01
"Delaware","2011-12",2011,12,12000,3640,8360,106.90537084399,"12",2011-12-01
"Delaware","2011-02",2011,2,9000,4654,4346,63.6590010253406,"02",2011-02-01
"Delaware","2011-03",2011,3,9000,6554,2446,31.4517166002314,"03",2011-03-01
"Delaware","2011-04",2011,4,12000,4812,7188,85.5103497501784,"04",2011-04-01
"Delaware","2011-05",2011,5,12000,5583,6417,72.9909571745436,"05",2011-05-01
"Delaware","2011-06",2011,6,13000,4973,8027,89.3228731986869,"06",2011-06-01
"Delaware","2011-07",2011,7,15000,5323,9677,95.2320031491414,"07",2011-07-01
"Delaware","2011-08",2011,8,14000,4495,9505,102.784536361179,"08",2011-08-01
"Delaware","2011-09",2011,9,14000,3665,10335,117.011038777243,"09",2011-09-01
"Delaware","2012-01",2012,1,14000,10553,3447,28.078035270639,"01",2012-01-01
"Delaware","2012-10",2012,10,13000,5684,7316,78.3129950760009,"10",2012-10-01
"Delaware","2012-11",2012,11,13000,9253,3747,33.6763582438323,"11",2012-11-01
"Delaware","2012-12",2012,12,13000,5530,7470,80.626011872639,"12",2012-12-01
"Delaware","2012-02",2012,2,14000,6545,7455,72.572402044293,"02",2012-02-01
"Delaware","2012-03",2012,3,14000,5980,8020,80.2802802802803,"03",2012-03-01
"Delaware","2012-04",2012,4,14000,6907,7093,67.8528722437461,"04",2012-04-01
"Delaware","2012-05",2012,5,15000,6695,8305,76.5614196819544,"05",2012-05-01
"Delaware","2012-06",2012,6,16000,4171,11829,117.287194487135,"06",2012-06-01
"Delaware","2012-07",2012,7,16000,3955,12045,120.72162365322,"07",2012-07-01
"Delaware","2012-08",2012,8,14000,3573,10427,118.670687987253,"08",2012-08-01
"Delaware","2012-09",2012,9,13000,3829,9171,108.990433180819,"09",2012-09-01
"Delaware","2013-01",2013,1,13000,5366,7634,83.1318741152129,"01",2013-01-01
"Delaware","2013-10",2013,10,14000,6493,7507,73.2640413799834,"10",2013-10-01
"Delaware","2013-11",2013,11,14000,5575,8425,86.0791826309068,"11",2013-11-01
"Delaware","2013-12",2013,12,13000,6419,6581,67.778979350121,"12",2013-12-01
"Delaware","2013-02",2013,2,13000,4815,8185,91.8888577041819,"02",2013-02-01
"Delaware","2013-03",2013,3,13000,5046,7954,88.1524991687909,"03",2013-03-01
"Delaware","2013-04",2013,4,14000,4513,9487,102.490142062335,"04",2013-04-01
"Delaware","2013-05",2013,5,15000,4777,10223,103.382717297871,"05",2013-05-01
"Delaware","2013-06",2013,6,16000,5926,10074,91.890905773967,"06",2013-06-01
"Delaware","2013-07",2013,7,16000,7872,8128,68.0965147453083,"07",2013-07-01
"Delaware","2013-08",2013,8,14000,6454,7546,73.7850787132101,"08",2013-08-01
"Delaware","2013-09",2013,9,14000,6258,7742,76.43400138217,"09",2013-09-01
"Delaware","2014-01",2014,1,12000,7056,4944,51.8891687657431,"01",2014-01-01
"Delaware","2014-10",2014,10,18000,7338,10662,84.1581813876391,"10",2014-10-01
"Delaware","2014-11",2014,11,19000,5621,13379,108.679582470249,"11",2014-11-01
"Delaware","2014-12",2014,12,19000,5651,13349,108.303922761754,"12",2014-12-01
"Delaware","2014-02",2014,2,12000,7532,4468,45.750563178374,"02",2014-02-01
"Delaware","2014-03",2014,3,13000,7575,5425,52.73390036452,"03",2014-03-01
"Delaware","2014-04",2014,4,15000,7298,7702,69.0824289173917,"04",2014-04-01
"Delaware","2014-05",2014,5,16000,6536,9464,83.9900603478878,"05",2014-05-01
"Delaware","2014-06",2014,6,18000,4938,13062,113.889615485221,"06",2014-06-01
"Delaware","2014-07",2014,7,18000,5207,12793,110.251217305123,"07",2014-07-01
"Delaware","2014-08",2014,8,17000,6577,10423,88.416677270221,"08",2014-08-01
"Delaware","2014-09",2014,9,17000,8053,8947,71.4245798906319,"09",2014-09-01
"Delaware","2015-01",2015,1,17000,5182,11818,106.554864304391,"01",2015-01-01
"Delaware","2015-10",2015,10,19000,9629,9371,65.4650878479863,"10",2015-10-01
"Delaware","2015-11",2015,11,22000,7316,14684,100.177377541274,"11",2015-11-01
"Delaware","2015-12",2015,12,21000,7232,13768,97.5347123831114,"12",2015-12-01
"Delaware","2015-02",2015,2,16000,4613,11387,110.483675350507,"02",2015-02-01
"Delaware","2015-03",2015,3,17000,6268,10732,92.2468626439746,"03",2015-03-01
"Delaware","2015-04",2015,4,20000,6938,13062,96.9782463434553,"04",2015-04-01
"Delaware","2015-05",2015,5,23000,6564,16436,111.189284264646,"05",2015-05-01
"Delaware","2015-06",2015,6,23000,6683,16317,109.941717481387,"06",2015-06-01
"Delaware","2015-07",2015,7,22000,7527,14473,98.0323094117249,"07",2015-07-01
"Delaware","2015-08",2015,8,20000,6865,13135,97.785222408338,"08",2015-08-01
"Delaware","2015-09",2015,9,19000,6350,12650,99.8027613412229,"09",2015-09-01
"Delaware","2016-01",2016,1,20000,7770,12230,88.080662585524,"01",2016-01-01
"Delaware","2016-10",2016,10,17000,8863,8137,62.9238680740827,"10",2016-10-01
"Delaware","2016-11",2016,11,18000,8392,9608,72.8099424067899,"11",2016-11-01
"Delaware","2016-12",2016,12,17000,7671,9329,75.6272546714766,"12",2016-12-01
"Delaware","2016-02",2016,2,18000,7382,10618,83.6655897880388,"02",2016-02-01
"Delaware","2016-03",2016,3,20000,8136,11864,84.3332385555872,"03",2016-03-01
"Delaware","2016-04",2016,4,21000,8799,12201,81.8886539816772,"04",2016-04-01
"Delaware","2016-05",2016,5,22000,7503,14497,98.2747517201641,"05",2016-05-01
"Delaware","2016-06",2016,6,23000,7984,15016,96.9274464239607,"06",2016-06-01
"Delaware","2016-07",2016,7,22000,8374,13626,89.7214723118457,"07",2016-07-01
"Delaware","2016-08",2016,8,21000,8401,12599,85.7045678718411,"08",2016-08-01
"Delaware","2016-09",2016,9,18000,9818,8182,58.8252210798763,"09",2016-09-01
"Delaware","2017-01",2017,1,18000,9159,8841,65.1054898928532,"01",2017-01-01
"Delaware","2017-10",2017,10,17000,7245,9755,80.4702000412456,"10",2017-10-01
"Delaware","2017-11",2017,11,19000,5865,13135,105.650512768952,"11",2017-11-01
"Delaware","2017-12",2017,12,18000,5757,12243,103.068569263796,"12",2017-12-01
"Delaware","2017-02",2017,2,17000,11197,5803,41.1604071355109,"02",2017-02-01
"Delaware","2017-03",2017,3,18000,12380,5620,36.9980250164582,"03",2017-03-01
"Delaware","2017-04",2017,4,21000,10039,10961,70.6272753632527,"04",2017-04-01
"Delaware","2017-05",2017,5,21000,9689,11311,73.7137084949005,"05",2017-05-01
"Delaware","2017-06",2017,6,23000,10258,12742,76.6251728907331,"06",2017-06-01
"Delaware","2017-07",2017,7,22000,10069,11931,74.4083070878418,"07",2017-07-01
"Delaware","2017-08",2017,8,21000,7439,13561,95.3690354794472,"08",2017-08-01
"Delaware","2017-09",2017,9,19000,6455,12545,98.5660970339815,"09",2017-09-01
"Delaware","2018-01",2018,1,19000,7395,11605,87.9333207046789,"01",2018-01-01
"Delaware","2018-10",2018,10,21000,5354,15646,118.7371935949,"10",2018-10-01
"Delaware","2018-11",2018,11,23000,4941,18059,129.265237464658,"11",2018-11-01
"Delaware","2018-12",2018,12,22000,4783,17217,128.566628084979,"12",2018-12-01
"Delaware","2018-02",2018,2,19000,7758,11242,84.027206816653,"02",2018-02-01
"Delaware","2018-03",2018,3,19000,10202,8798,60.2561468392576,"03",2018-03-01
"Delaware","2018-04",2018,4,21000,7570,13430,94.0147007350368,"04",2018-04-01
"Delaware","2018-05",2018,5,23000,9543,13457,82.7028854131457,"05",2018-05-01
"Delaware","2018-06",2018,6,26000,6363,19637,121.354633377623,"06",2018-06-01
"Delaware","2018-07",2018,7,26000,7519,18481,110.271786151138,"07",2018-07-01
"Delaware","2018-08",2018,8,24000,7167,16833,108.018096063144,"08",2018-08-01
"Delaware","2018-09",2018,9,22000,6743,15257,106.161500191351,"09",2018-09-01
"Delaware","2019-01",2019,1,22000,5393,16607,121.249954367904,"01",2019-01-01
"Delaware","2019-10",2019,10,22000,7041,14959,103.01986846183,"10",2019-10-01
"Delaware","2019-11",2019,11,23000,7789,15211,98.8080158498165,"11",2019-11-01
"Delaware","2019-12",2019,12,22000,6498,15502,108.793599550846,"12",2019-12-01
"Delaware","2019-02",2019,2,21000,5660,15340,115.078769692423,"02",2019-02-01
"Delaware","2019-03",2019,3,21000,7579,13421,93.9221106406802,"03",2019-03-01
"Delaware","2019-04",2019,4,23000,5467,17533,123.181227386096,"04",2019-04-01
"Delaware","2019-05",2019,5,25000,6280,18720,119.693094629156,"05",2019-05-01
"Delaware","2019-06",2019,6,26000,5809,20191,126.951491716181,"06",2019-06-01
"Delaware","2019-07",2019,7,26000,4923,21077,136.319244575235,"07",2019-07-01
"Delaware","2019-08",2019,8,24000,7246,16754,107.239326633809,"08",2019-08-01
"Delaware","2019-09",2019,9,22000,7164,14836,101.741873542724,"09",2019-09-01
"District of Columbia","2010-01",2010,1,20000,2121,17879,161.647303467294,"01",2010-01-01
"District of Columbia","2010-10",2010,10,16000,12606,3394,23.7292875620499,"10",2010-10-01
"District of Columbia","2010-11",2010,11,15000,10769,4231,32.8379060110986,"11",2010-11-01
"District of Columbia","2010-12",2010,12,16000,10555,5445,41.009226134438,"12",2010-12-01
"District of Columbia","2010-02",2010,2,19000,6568,12432,97.2465581977472,"02",2010-02-01
"District of Columbia","2010-03",2010,3,18000,7386,10614,83.6208934058142,"03",2010-03-01
"District of Columbia","2010-04",2010,4,16000,9595,6405,50.0488376636062,"04",2010-04-01
"District of Columbia","2010-05",2010,5,15000,17300,-2300,-14.2414860681115,"05",2010-05-01
"District of Columbia","2010-06",2010,6,16000,11687,4313,31.1554158991585,"06",2010-06-01
"District of Columbia","2010-07",2010,7,17000,12532,4468,30.2587024244887,"07",2010-07-01
"District of Columbia","2010-08",2010,8,17000,12978,4022,26.8330108746414,"08",2010-08-01
"District of Columbia","2010-09",2010,9,16000,11134,4866,35.8664406279944,"09",2010-09-01
"District of Columbia","2011-01",2011,1,14000,8926,5074,44.264154235366,"01",2011-01-01
"District of Columbia","2011-10",2011,10,17000,11111,5889,41.8981893209064,"10",2011-10-01
"District of Columbia","2011-11",2011,11,16000,7957,8043,67.1453019994156,"11",2011-11-01
"District of Columbia","2011-12",2011,12,16000,11062,4938,36.4939767940285,"12",2011-12-01
"District of Columbia","2011-02",2011,2,15000,8202,6798,58.5983966899405,"02",2011-02-01
"District of Columbia","2011-03",2011,3,14000,12295,1705,12.9682449134816,"03",2011-03-01
"District of Columbia","2011-04",2011,4,16000,10582,5418,40.7644270559025,"04",2011-04-01
"District of Columbia","2011-05",2011,5,17000,14641,2359,14.9110331531873,"05",2011-05-01
"District of Columbia","2011-06",2011,6,19000,10667,8333,56.176896888799,"06",2011-06-01
"District of Columbia","2011-07",2011,7,17000,11439,5561,39.1082668166954,"07",2011-07-01
"District of Columbia","2011-08",2011,8,17000,8029,8971,71.6848455791282,"08",2011-08-01
"District of Columbia","2011-09",2011,9,17000,8658,8342,65.0245537454205,"09",2011-09-01
"District of Columbia","2012-01",2012,1,17000,12218,4782,32.7332466287905,"01",2012-01-01
"District of Columbia","2012-10",2012,10,19000,9425,9575,67.3702726473175,"10",2012-10-01
"District of Columbia","2012-11",2012,11,20000,9223,10777,73.7569722478869,"11",2012-11-01
"District of Columbia","2012-12",2012,12,19000,9146,9854,70.0206068357848,"12",2012-12-01
"District of Columbia","2012-02",2012,2,18000,11494,6506,44.1174476164644,"02",2012-02-01
"District of Columbia","2012-03",2012,3,19000,12749,6251,39.377618192699,"03",2012-03-01
"District of Columbia","2012-04",2012,4,18000,10156,7844,55.718141781503,"04",2012-04-01
"District of Columbia","2012-05",2012,5,19000,15839,3161,18.1463302620626,"05",2012-05-01
"District of Columbia","2012-06",2012,6,19000,8522,10478,76.1427221858877,"06",2012-06-01
"District of Columbia","2012-07",2012,7,19000,8231,10769,79.0936799970622,"07",2012-07-01
"District of Columbia","2012-08",2012,8,18000,8828,9172,68.3763232443715,"08",2012-08-01
"District of Columbia","2012-09",2012,9,17000,7917,9083,72.9060480796244,"09",2012-09-01
"District of Columbia","2013-01",2013,1,16000,12503,3497,24.5377679542504,"01",2013-01-01
"District of Columbia","2013-10",2013,10,17000,12161,4839,33.188162271527,"10",2013-10-01
"District of Columbia","2013-11",2013,11,16000,10403,5597,42.3966973449987,"11",2013-11-01
"District of Columbia","2013-12",2013,12,15000,10124,4876,38.8154752427957,"12",2013-12-01
"District of Columbia","2013-02",2013,2,17000,10130,6870,50.6450423884998,"02",2013-02-01
"District of Columbia","2013-03",2013,3,18000,10132,7868,55.9363002985923,"03",2013-03-01
"District of Columbia","2013-04",2013,4,19000,11216,7784,51.5223722531109,"04",2013-04-01
"District of Columbia","2013-05",2013,5,18000,11377,6623,45.0896960206965,"05",2013-05-01
"District of Columbia","2013-06",2013,6,18000,16516,1484,8.59891065013327,"06",2013-06-01
"District of Columbia","2013-07",2013,7,18000,13212,4788,30.6805074971165,"07",2013-07-01
"District of Columbia","2013-08",2013,8,17000,11778,5222,36.2916116477865,"08",2013-08-01
"District of Columbia","2013-09",2013,9,17000,11324,5676,40.0790848750176,"09",2013-09-01
"District of Columbia","2014-01",2014,1,15000,12934,2066,14.7920097372378,"01",2014-01-01
"District of Columbia","2014-10",2014,10,25000,11381,13619,74.868750171793,"10",2014-10-01
"District of Columbia","2014-11",2014,11,26000,10184,15816,87.419854079151,"11",2014-11-01
"District of Columbia","2014-12",2014,12,25000,11645,13355,72.8885250375222,"12",2014-12-01
"District of Columbia","2014-02",2014,2,17000,12937,4063,27.1436683702442,"02",2014-02-01
"District of Columbia","2014-03",2014,3,19000,12927,6073,38.0430356751339,"03",2014-03-01
"District of Columbia","2014-04",2014,4,19000,13887,5113,31.0943533919178,"04",2014-04-01
"District of Columbia","2014-05",2014,5,21000,13235,7765,45.3629326712429,"05",2014-05-01
"District of Columbia","2014-06",2014,6,23000,10146,12854,77.5598865624811,"06",2014-06-01
"District of Columbia","2014-07",2014,7,24000,9995,14005,82.3944697749669,"07",2014-07-01
"District of Columbia","2014-08",2014,8,24000,12195,11805,65.2300041442188,"08",2014-08-01
"District of Columbia","2014-09",2014,9,24000,12258,11742,64.7691543935131,"09",2014-09-01
"District of Columbia","2015-01",2015,1,25000,12459,12541,66.9585413385301,"01",2015-01-01
"District of Columbia","2015-10",2015,10,27000,16219,10781,49.8900946343044,"10",2015-10-01
"District of Columbia","2015-11",2015,11,28000,13505,14495,69.8470063847729,"11",2015-11-01
"District of Columbia","2015-12",2015,12,28000,13609,14391,69.1725347881468,"12",2015-12-01
"District of Columbia","2015-02",2015,2,26000,11465,14535,77.5924195916188,"02",2015-02-01
"District of Columbia","2015-03",2015,3,24000,12490,11510,63.085776925185,"03",2015-03-01
"District of Columbia","2015-04",2015,4,25000,12515,12485,66.5600426496068,"04",2015-04-01
"District of Columbia","2015-05",2015,5,25000,15270,9730,48.3238142537869,"05",2015-05-01
"District of Columbia","2015-06",2015,6,27000,17419,9581,43.1391971903915,"06",2015-06-01
"District of Columbia","2015-07",2015,7,28000,20801,7199,29.5034937808651,"07",2015-07-01
"District of Columbia","2015-08",2015,8,28000,17266,10734,47.4263243935846,"08",2015-08-01
"District of Columbia","2015-09",2015,9,28000,17077,10923,48.4637398229696,"09",2015-09-01
"District of Columbia","2016-01",2016,1,28000,16623,11377,50.9916410819533,"01",2016-01-01
"District of Columbia","2016-10",2016,10,26000,13917,12083,60.5406217902147,"10",2016-10-01
"District of Columbia","2016-11",2016,11,26000,12572,13428,69.6256351757752,"11",2016-11-01
"District of Columbia","2016-12",2016,12,25000,12118,12882,69.4110674066491,"12",2016-12-01
"District of Columbia","2016-02",2016,2,28000,15055,12945,60.1323888050168,"02",2016-02-01
"District of Columbia","2016-03",2016,3,28000,14694,13306,62.3319435986321,"03",2016-03-01
"District of Columbia","2016-04",2016,4,30000,13263,16737,77.3732750849456,"04",2016-04-01
"District of Columbia","2016-05",2016,5,30000,12300,17700,83.6879432624114,"05",2016-05-01
"District of Columbia","2016-06",2016,6,31000,15924,15076,64.2570965817066,"06",2016-06-01
"District of Columbia","2016-07",2016,7,30000,15888,14112,61.5062761506276,"07",2016-07-01
"District of Columbia","2016-08",2016,8,29000,12408,16592,80.1391035548686,"08",2016-08-01
"District of Columbia","2016-09",2016,9,29000,14440,14560,67.0349907918969,"09",2016-09-01
"District of Columbia","2017-01",2017,1,26000,12976,13024,66.8308702791461,"01",2017-01-01
"District of Columbia","2017-10",2017,10,27000,12802,14198,71.3431485854982,"10",2017-10-01
"District of Columbia","2017-11",2017,11,26000,11213,14787,79.4722274473974,"11",2017-11-01
"District of Columbia","2017-12",2017,12,22000,9234,12766,81.7442530575655,"12",2017-12-01
"District of Columbia","2017-02",2017,2,26000,14321,11679,57.9301108603457,"02",2017-02-01
"District of Columbia","2017-03",2017,3,29000,15951,13049,58.0587751106761,"03",2017-03-01
"District of Columbia","2017-04",2017,4,28000,11575,16425,83.0069488313329,"04",2017-04-01
"District of Columbia","2017-05",2017,5,28000,12763,15237,74.7589725976989,"05",2017-05-01
"District of Columbia","2017-06",2017,6,29000,14076,14924,69.2914848175318,"06",2017-06-01
"District of Columbia","2017-07",2017,7,30000,15126,14874,65.922084829145,"07",2017-07-01
"District of Columbia","2017-08",2017,8,30000,14313,15687,70.800893642949,"08",2017-08-01
"District of Columbia","2017-09",2017,9,29000,12159,16841,81.8338637964965,"09",2017-09-01
"District of Columbia","2018-01",2018,1,25000,12047,12953,69.9273895322158,"01",2018-01-01
"District of Columbia","2018-10",2018,10,29000,27745,1255,4.42329720680236,"10",2018-10-01
"District of Columbia","2018-11",2018,11,29000,31459,-2459,-8.13443821432707,"11",2018-11-01
"District of Columbia","2018-12",2018,12,27000,22581,4419,17.8253766563805,"12",2018-12-01
"District of Columbia","2018-02",2018,2,25000,11648,13352,72.8661864221786,"02",2018-02-01
"District of Columbia","2018-03",2018,3,27000,19107,7893,34.2377513175874,"03",2018-03-01
"District of Columbia","2018-04",2018,4,25000,20481,4519,19.872034475935,"04",2018-04-01
"District of Columbia","2018-05",2018,5,27000,27478,-478,-1.75483681486104,"05",2018-05-01
"District of Columbia","2018-06",2018,6,28000,19173,8827,37.4239501409705,"06",2018-06-01
"District of Columbia","2018-07",2018,7,30000,25817,4183,14.9882652238565,"07",2018-07-01
"District of Columbia","2018-08",2018,8,28000,26293,1707,6.28810343874901,"08",2018-08-01
"District of Columbia","2018-09",2018,9,28000,20643,7357,30.248956684415,"09",2018-09-01
"District of Columbia","2019-01",2019,1,27000,20512,6488,27.3109951170231,"01",2019-01-01
"District of Columbia","2019-10",2019,10,32000,25011,6989,24.5180754591219,"10",2019-10-01
"District of Columbia","2019-11",2019,11,32000,23658,8342,29.9759243954149,"11",2019-11-01
"District of Columbia","2019-12",2019,12,29000,24429,4571,17.110557936701,"12",2019-12-01
"District of Columbia","2019-02",2019,2,28000,20834,7166,29.3484047999345,"02",2019-02-01
"District of Columbia","2019-03",2019,3,30000,24422,5578,20.4990628789828,"03",2019-03-01
"District of Columbia","2019-04",2019,4,29000,19696,9304,38.2125841958272,"04",2019-04-01
"District of Columbia","2019-05",2019,5,30000,24658,5342,19.5470013538732,"05",2019-05-01
"District of Columbia","2019-06",2019,6,31000,18855,12145,48.7212917460636,"06",2019-06-01
"District of Columbia","2019-07",2019,7,32000,19489,12511,48.5967876633844,"07",2019-07-01
"District of Columbia","2019-08",2019,8,30000,26552,3448,12.1940868581129,"08",2019-08-01
"District of Columbia","2019-09",2019,9,31000,26324,4676,16.3142837206057,"09",2019-09-01
"Florida","2010-01",2010,1,137000,12334,124666,166.962647488181,"01",2010-01-01
"Florida","2010-10",2010,10,194000,59815,134185,105.734491657309,"10",2010-10-01
"Florida","2010-11",2010,11,197000,52772,144228,115.487724805022,"11",2010-11-01
"Florida","2010-12",2010,12,187000,56450,130550,107.249948654755,"12",2010-12-01
"Florida","2010-02",2010,2,132000,36884,95116,112.640629070842,"02",2010-02-01
"Florida","2010-03",2010,3,139000,35333,103667,118.929864110639,"03",2010-03-01
"Florida","2010-04",2010,4,150000,42226,107774,112.1325939259,"04",2010-04-01
"Florida","2010-05",2010,5,170000,49106,120894,110.352067036046,"05",2010-05-01
"Florida","2010-06",2010,6,180000,40335,139665,126.775137858261,"06",2010-06-01
"Florida","2010-07",2010,7,183000,54120,128880,108.704453441296,"07",2010-07-01
"Florida","2010-08",2010,8,178000,49942,128058,112.360161795544,"08",2010-08-01
"Florida","2010-09",2010,9,183000,55825,127175,106.500575735371,"09",2010-09-01
"Florida","2011-01",2011,1,169000,51832,117168,106.115055789016,"01",2011-01-01
"Florida","2011-10",2011,10,198000,52842,145158,115.736599134116,"10",2011-10-01
"Florida","2011-11",2011,11,206000,44657,161343,128.736081577614,"11",2011-11-01
"Florida","2011-12",2011,12,201000,51907,149093,117.903419043364,"12",2011-12-01
"Florida","2011-02",2011,2,170000,47200,122800,113.075506445672,"02",2011-02-01
"Florida","2011-03",2011,3,178000,72359,105641,84.3916136428089,"03",2011-03-01
"Florida","2011-04",2011,4,188000,54854,133146,109.65106607262,"04",2011-04-01
"Florida","2011-05",2011,5,187000,67224,119776,94.2287116873309,"05",2011-05-01
"Florida","2011-06",2011,6,189000,62993,126007,100.008333564821,"06",2011-06-01
"Florida","2011-07",2011,7,187000,59181,127819,103.841482486463,"07",2011-07-01
"Florida","2011-08",2011,8,189000,56416,132584,108.048375004075,"08",2011-08-01
"Florida","2011-09",2011,9,195000,46799,148201,122.581979247226,"09",2011-09-01
"Florida","2012-01",2012,1,197000,59452,137548,107.269976447834,"01",2012-01-01
"Florida","2012-10",2012,10,231000,47536,183464,131.734497515581,"10",2012-10-01
"Florida","2012-11",2012,11,227000,38568,188432,141.908663694421,"11",2012-11-01
"Florida","2012-12",2012,12,213000,48531,164469,125.774000022942,"12",2012-12-01
"Florida","2012-02",2012,2,199000,52100,146900,117.005177220231,"02",2012-02-01
"Florida","2012-03",2012,3,211000,58687,152313,112.955389025055,"03",2012-03-01
"Florida","2012-04",2012,4,242000,49053,192947,132.58547412327,"04",2012-04-01
"Florida","2012-05",2012,5,238000,64001,173999,115.230744269059,"05",2012-05-01
"Florida","2012-06",2012,6,232000,48170,183830,131.227469036656,"06",2012-06-01
"Florida","2012-07",2012,7,210000,40445,169555,135.40298269081,"07",2012-07-01
"Florida","2012-08",2012,8,216000,39620,176380,138.001721305062,"08",2012-08-01
"Florida","2012-09",2012,9,225000,40854,184146,138.531675280417,"09",2012-09-01
"Florida","2013-01",2013,1,199000,66326,132674,100.008291686454,"01",2013-01-01
"Florida","2013-10",2013,10,261000,84181,176819,102.450018975552,"10",2013-10-01
"Florida","2013-11",2013,11,260000,76679,183321,108.899574966066,"11",2013-11-01
"Florida","2013-12",2013,12,245000,74532,170468,106.698546624438,"12",2013-12-01
"Florida","2013-02",2013,2,196000,53906,142094,113.71795795219,"02",2013-02-01
"Florida","2013-03",2013,3,201000,59297,141703,108.877935588962,"03",2013-03-01
"Florida","2013-04",2013,4,233000,45072,187928,135.164993239161,"04",2013-04-01
"Florida","2013-05",2013,5,254000,59406,194594,124.180136946963,"05",2013-05-01
"Florida","2013-06",2013,6,271000,96836,174164,94.6965495492556,"06",2013-06-01
"Florida","2013-07",2013,7,256000,99797,156203,87.8045627141319,"07",2013-07-01
"Florida","2013-08",2013,8,241000,89390,151610,91.7763854838222,"08",2013-08-01
"Florida","2013-09",2013,9,237000,87924,149076,91.760534771208,"09",2013-09-01
"Florida","2014-01",2014,1,219000,90554,128446,82.987782422453,"01",2014-01-01
"Florida","2014-10",2014,10,329000,86799,242201,116.49907767936,"10",2014-10-01
"Florida","2014-11",2014,11,308000,66019,241981,129.395030733733,"11",2014-11-01
"Florida","2014-12",2014,12,291000,69631,221369,122.767593468116,"12",2014-12-01
"Florida","2014-02",2014,2,243000,83549,159451,97.6582381204658,"02",2014-02-01
"Florida","2014-03",2014,3,263000,87475,175525,100.164063057279,"03",2014-03-01
"Florida","2014-04",2014,4,279000,89601,189399,102.76640595115,"04",2014-04-01
"Florida","2014-05",2014,5,280000,88787,191213,103.698340776654,"05",2014-05-01
"Florida","2014-06",2014,6,279000,69145,209855,120.556090134858,"06",2014-06-01
"Florida","2014-07",2014,7,277000,64469,212531,124.480406713347,"07",2014-07-01
"Florida","2014-08",2014,8,290000,74123,215877,118.573668787745,"08",2014-08-01
"Florida","2014-09",2014,9,308000,78950,229050,118.387388551492,"09",2014-09-01
"Florida","2015-01",2015,1,274000,73050,200950,115.804639100994,"01",2015-01-01
"Florida","2015-10",2015,10,310000,95925,214075,105.475149350249,"10",2015-10-01
"Florida","2015-11",2015,11,311000,86506,224494,112.951251050299,"11",2015-11-01
"Florida","2015-12",2015,12,303000,82126,220874,114.702201357478,"12",2015-12-01
"Florida","2015-02",2015,2,293000,61736,231264,130.386540976952,"02",2015-02-01
"Florida","2015-03",2015,3,308000,75206,232794,121.498097628952,"03",2015-03-01
"Florida","2015-04",2015,4,330000,82365,247635,120.104761558328,"04",2015-04-01
"Florida","2015-05",2015,5,326000,83227,242773,118.649551471433,"05",2015-05-01
"Florida","2015-06",2015,6,324000,103809,220191,102.938928353541,"06",2015-06-01
"Florida","2015-07",2015,7,320000,124731,195269,87.8144316451967,"07",2015-07-01
"Florida","2015-08",2015,8,323000,111476,211524,97.3697051160478,"08",2015-08-01
"Florida","2015-09",2015,9,322000,93506,228494,109.983490009771,"09",2015-09-01
"Florida","2016-01",2016,1,302000,97400,204600,102.453680520781,"01",2016-01-01
"Florida","2016-10",2016,10,340000,98602,241398,110.076105444116,"10",2016-10-01
"Florida","2016-11",2016,11,341000,88079,252921,117.890178731655,"11",2016-11-01
"Florida","2016-12",2016,12,334000,82938,251062,120.431335114573,"12",2016-12-01
"Florida","2016-02",2016,2,293000,87199,205801,108.259621934829,"02",2016-02-01
"Florida","2016-03",2016,3,312000,96875,215125,105.227759095078,"03",2016-03-01
"Florida","2016-04",2016,4,331000,90905,240095,113.814721323521,"04",2016-04-01
"Florida","2016-05",2016,5,337000,85267,251733,119.229302787099,"05",2016-05-01
"Florida","2016-06",2016,6,355000,96046,258954,114.823765203549,"06",2016-06-01
"Florida","2016-07",2016,7,354000,104612,249388,108.757729845708,"07",2016-07-01
"Florida","2016-08",2016,8,355000,89575,265425,119.406174436259,"08",2016-08-01
"Florida","2016-09",2016,9,340000,104649,235351,105.859228290179,"09",2016-09-01
"Florida","2017-01",2017,1,318000,95978,222022,107.262704781414,"01",2017-01-01
"Florida","2017-10",2017,10,347000,89607,257393,117.906034488682,"10",2017-10-01
"Florida","2017-11",2017,11,359000,78827,280173,127.983427244094,"11",2017-11-01
"Florida","2017-12",2017,12,379000,63998,315002,142.213734599253,"12",2017-12-01
"Florida","2017-02",2017,2,328000,99900,228100,106.613694788502,"02",2017-02-01
"Florida","2017-03",2017,3,339000,110402,228598,101.734304698243,"03",2017-03-01
"Florida","2017-04",2017,4,351000,101208,249792,110.476594841312,"04",2017-04-01
"Florida","2017-05",2017,5,333000,100123,232877,107.533887602367,"05",2017-05-01
"Florida","2017-06",2017,6,316000,103933,212067,101.000397682487,"06",2017-06-01
"Florida","2017-07",2017,7,318000,96742,221258,106.696693365996,"07",2017-07-01
"Florida","2017-08",2017,8,335000,99252,235748,108.576586866612,"08",2017-08-01
"Florida","2017-09",2017,9,327000,81280,245720,120.368374644852,"09",2017-09-01
"Florida","2018-01",2018,1,364000,84045,279955,124.967358189468,"01",2018-01-01
"Florida","2018-10",2018,10,439000,134027,304973,106.442802869673,"10",2018-10-01
"Florida","2018-11",2018,11,446000,141438,304562,103.691623626664,"11",2018-11-01
"Florida","2018-12",2018,12,456000,134610,321390,108.833240209275,"12",2018-12-01
"Florida","2018-02",2018,2,370000,86508,283492,124.200233073681,"02",2018-02-01
"Florida","2018-03",2018,3,397000,111335,285665,112.392418385513,"03",2018-03-01
"Florida","2018-04",2018,4,438000,113087,324913,117.917134681094,"04",2018-04-01
"Florida","2018-05",2018,5,452000,152425,299575,99.1272697191546,"05",2018-05-01
"Florida","2018-06",2018,6,455000,111771,343229,121.117347217836,"06",2018-06-01
"Florida","2018-07",2018,7,447000,150169,296831,99.4127290599479,"07",2018-07-01
"Florida","2018-08",2018,8,447000,129275,317725,110.268534987636,"08",2018-08-01
"Florida","2018-09",2018,9,441000,123255,317745,112.624611213015,"09",2018-09-01
"Florida","2019-01",2019,1,449000,124252,324748,113.300258873933,"01",2019-01-01
"Florida","2019-10",2019,10,434000,188432,245568,78.9059688447895,"10",2019-10-01
"Florida","2019-11",2019,11,432000,163334,268666,90.2572337544975,"11",2019-11-01
"Florida","2019-12",2019,12,422000,199728,222272,71.5013639405013,"12",2019-12-01
"Florida","2019-02",2019,2,413000,126533,286467,106.190724200373,"02",2019-02-01
"Florida","2019-03",2019,3,415000,166520,248480,85.4587976337873,"03",2019-03-01
"Florida","2019-04",2019,4,419000,143115,275885,98.1596292573584,"04",2019-04-01
"Florida","2019-05",2019,5,439000,161459,277541,92.4429478115908,"05",2019-05-01
"Florida","2019-06",2019,6,419000,133970,285030,103.090583575963,"06",2019-06-01
"Florida","2019-07",2019,7,417000,124031,292969,108.300263755681,"07",2019-07-01
"Florida","2019-08",2019,8,421000,154835,266165,92.444884385284,"08",2019-08-01
"Florida","2019-09",2019,9,428000,172035,255965,85.3166898597582,"09",2019-09-01
"Georgia","2010-01",2010,1,65000,5151,59849,170.629071574176,"01",2010-01-01
"Georgia","2010-10",2010,10,95000,36192,58808,89.6518080370754,"10",2010-10-01
"Georgia","2010-11",2010,11,97000,31690,65310,101.499728028596,"11",2010-11-01
"Georgia","2010-12",2010,12,93000,33314,59686,94.5041721424387,"12",2010-12-01
"Georgia","2010-02",2010,2,68000,18158,49842,115.69906450939,"02",2010-02-01
"Georgia","2010-03",2010,3,69000,22867,46133,100.434323532933,"03",2010-03-01
"Georgia","2010-04",2010,4,74000,25739,48261,96.7745816581277,"04",2010-04-01
"Georgia","2010-05",2010,5,77000,28822,48178,91.0547901192569,"05",2010-05-01
"Georgia","2010-06",2010,6,80000,24479,55521,106.281645115286,"06",2010-06-01
"Georgia","2010-07",2010,7,82000,33519,48481,83.9359759000684,"07",2010-07-01
"Georgia","2010-08",2010,8,84000,30598,53402,93.1988341855879,"08",2010-08-01
"Georgia","2010-09",2010,9,89000,34250,54750,88.8438133874239,"09",2010-09-01
"Georgia","2011-01",2011,1,87000,35429,51571,84.2463795342607,"01",2011-01-01
"Georgia","2011-10",2011,10,95000,44008,50992,73.365561694291,"10",2011-10-01
"Georgia","2011-11",2011,11,98000,28634,69366,109.553516433185,"11",2011-11-01
"Georgia","2011-12",2011,12,92000,33080,58920,94.2117045091142,"12",2011-12-01
"Georgia","2011-02",2011,2,87000,31434,55566,93.8345407568772,"02",2011-02-01
"Georgia","2011-03",2011,3,91000,48909,42091,60.1691099214489,"03",2011-03-01
"Georgia","2011-04",2011,4,94000,36758,57242,87.5541075880634,"04",2011-04-01
"Georgia","2011-05",2011,5,91000,57785,33215,44.6483180428135,"05",2011-05-01
"Georgia","2011-06",2011,6,87000,47031,39969,59.6414262372138,"06",2011-06-01
"Georgia","2011-07",2011,7,84000,48943,35057,52.7398960456737,"07",2011-07-01
"Georgia","2011-08",2011,8,85000,41581,43419,68.6027128874002,"08",2011-08-01
"Georgia","2011-09",2011,9,95000,42026,52974,77.3196327704231,"09",2011-09-01
"Georgia","2012-01",2012,1,104000,40212,63788,88.4642054752725,"01",2012-01-01
"Georgia","2012-10",2012,10,111000,42573,68427,89.1133207009045,"10",2012-10-01
"Georgia","2012-11",2012,11,102000,35190,66810,97.3977695167286,"11",2012-11-01
"Georgia","2012-12",2012,12,101000,44705,56295,77.2725712913078,"12",2012-12-01
"Georgia","2012-02",2012,2,105000,38015,66985,93.6754885851135,"02",2012-02-01
"Georgia","2012-03",2012,3,109000,53533,55467,68.2532162699267,"03",2012-03-01
"Georgia","2012-04",2012,4,104000,43430,60570,82.1678084514685,"04",2012-04-01
"Georgia","2012-05",2012,5,108000,49742,58258,73.8649186646549,"05",2012-05-01
"Georgia","2012-06",2012,6,108000,46397,61603,79.798182607175,"06",2012-06-01
"Georgia","2012-07",2012,7,105000,39469,65531,90.7198084018025,"07",2012-07-01
"Georgia","2012-08",2012,8,109000,41887,67113,88.9579619185218,"08",2012-08-01
"Georgia","2012-09",2012,9,110000,38970,71030,95.3614821776196,"09",2012-09-01
"Georgia","2013-01",2013,1,109000,55050,53950,65.7726302956416,"01",2013-01-01
"Georgia","2013-10",2013,10,133000,47609,85391,94.5589643926936,"10",2013-10-01
"Georgia","2013-11",2013,11,127000,44874,82126,95.5653560166168,"11",2013-11-01
"Georgia","2013-12",2013,12,118000,40322,77678,98.1266027463018,"12",2013-12-01
"Georgia","2013-02",2013,2,115000,41952,73048,93.0832356389215,"02",2013-02-01
"Georgia","2013-03",2013,3,124000,44469,79531,94.4161833927904,"03",2013-03-01
"Georgia","2013-04",2013,4,123000,32498,90502,116.402783315541,"04",2013-04-01
"Georgia","2013-05",2013,5,129000,40525,88475,104.379884972718,"05",2013-05-01
"Georgia","2013-06",2013,6,120000,54285,65715,75.4109647990361,"06",2013-06-01
"Georgia","2013-07",2013,7,119000,61126,57874,64.2594628204701,"07",2013-07-01
"Georgia","2013-08",2013,8,118000,62833,55167,61.0143060171539,"08",2013-08-01
"Georgia","2013-09",2013,9,127000,58103,68897,74.4417972696283,"09",2013-09-01
"Georgia","2014-01",2014,1,108000,51375,56625,71.0588235294118,"01",2014-01-01
"Georgia","2014-10",2014,10,159000,56756,102244,94.7774337677747,"10",2014-10-01
"Georgia","2014-11",2014,11,151000,35089,115911,124.57587498455,"11",2014-11-01
"Georgia","2014-12",2014,12,140000,41857,98143,107.934256036336,"12",2014-12-01
"Georgia","2014-02",2014,2,111000,44736,66264,85.0978579133919,"02",2014-02-01
"Georgia","2014-03",2014,3,122000,52940,69060,78.9527838115925,"03",2014-03-01
"Georgia","2014-04",2014,4,140000,55968,84032,85.7609405617244,"04",2014-04-01
"Georgia","2014-05",2014,5,149000,56839,92161,89.546684544717,"05",2014-05-01
"Georgia","2014-06",2014,6,151000,51522,99478,98.2392036420735,"06",2014-06-01
"Georgia","2014-07",2014,7,149000,41191,107809,113.369192022756,"07",2014-07-01
"Georgia","2014-08",2014,8,151000,54833,96167,93.4417707559041,"08",2014-08-01
"Georgia","2014-09",2014,9,156000,51692,104308,100.444889547985,"09",2014-09-01
"Georgia","2015-01",2015,1,132000,37679,94321,111.175808438286,"01",2015-01-01
"Georgia","2015-10",2015,10,170000,62586,107414,92.3649746760338,"10",2015-10-01
"Georgia","2015-11",2015,11,163000,48478,114522,108.306301364681,"11",2015-11-01
"Georgia","2015-12",2015,12,166000,45002,120998,114.688960294215,"12",2015-12-01
"Georgia","2015-02",2015,2,139000,34203,104797,121.010606051858,"02",2015-02-01
"Georgia","2015-03",2015,3,154000,41804,112196,114.600314600315,"03",2015-03-01
"Georgia","2015-04",2015,4,165000,41957,123043,118.906826055654,"04",2015-04-01
"Georgia","2015-05",2015,5,184000,47897,136103,117.382286101157,"05",2015-05-01
"Georgia","2015-06",2015,6,183000,53916,129084,108.970267943068,"06",2015-06-01
"Georgia","2015-07",2015,7,196000,63768,132232,101.807766930492,"07",2015-07-01
"Georgia","2015-08",2015,8,187000,54985,132015,109.110068805918,"08",2015-08-01
"Georgia","2015-09",2015,9,185000,52497,132503,111.582883152208,"09",2015-09-01
"Georgia","2016-01",2016,1,174000,63051,110949,93.6077046711467,"01",2016-01-01
"Georgia","2016-10",2016,10,194000,63999,130001,100.776359598293,"10",2016-10-01
"Georgia","2016-11",2016,11,194000,56380,137620,109.928908059749,"11",2016-11-01
"Georgia","2016-12",2016,12,185000,52801,132199,111.184561881573,"12",2016-12-01
"Georgia","2016-02",2016,2,186000,55733,130267,107.777589323758,"02",2016-02-01
"Georgia","2016-03",2016,3,206000,70885,135115,97.5964750708778,"03",2016-03-01
"Georgia","2016-04",2016,4,212000,57903,154097,114.186948644513,"04",2016-04-01
"Georgia","2016-05",2016,5,215000,54422,160578,119.201846916733,"05",2016-05-01
"Georgia","2016-06",2016,6,199000,59989,139011,107.348960766673,"06",2016-06-01
"Georgia","2016-07",2016,7,196000,64625,131375,100.815347721823,"07",2016-07-01
"Georgia","2016-08",2016,8,190000,59729,130271,104.329893604667,"08",2016-08-01
"Georgia","2016-09",2016,9,198000,68683,129317,96.9818098641458,"09",2016-09-01
"Georgia","2017-01",2017,1,183000,59916,123084,101.338734377316,"01",2017-01-01
"Georgia","2017-10",2017,10,201000,51820,149180,118.012815441816,"10",2017-10-01
"Georgia","2017-11",2017,11,203000,44837,158163,127.634695384466,"11",2017-11-01
"Georgia","2017-12",2017,12,198000,38049,159951,135.523556549699,"12",2017-12-01
"Georgia","2017-02",2017,2,189000,62372,126628,100.749486816352,"02",2017-02-01
"Georgia","2017-03",2017,3,194000,74701,119299,88.7968410984701,"03",2017-03-01
"Georgia","2017-04",2017,4,212000,69408,142592,101.341823970889,"04",2017-04-01
"Georgia","2017-05",2017,5,212000,64165,147835,107.062806655442,"05",2017-05-01
"Georgia","2017-06",2017,6,216000,67686,148314,104.562086250291,"06",2017-06-01
"Georgia","2017-07",2017,7,208000,69922,138078,99.3645699153,"07",2017-07-01
"Georgia","2017-08",2017,8,207000,65622,141378,103.717234852653,"08",2017-08-01
"Georgia","2017-09",2017,9,205000,55328,149672,114.98724685781,"09",2017-09-01
"Georgia","2018-01",2018,1,203000,48611,154389,122.720389808077,"01",2018-01-01
"Georgia","2018-10",2018,10,234000,76137,157863,101.802106810861,"10",2018-10-01
"Georgia","2018-11",2018,11,234000,72130,161870,105.752458106033,"11",2018-11-01
"Georgia","2018-12",2018,12,236000,69986,166014,108.510846901492,"12",2018-12-01
"Georgia","2018-02",2018,2,207000,51699,155301,120.063084897893,"02",2018-02-01
"Georgia","2018-03",2018,3,224000,64502,159498,110.569770746823,"03",2018-03-01
"Georgia","2018-04",2018,4,237000,58023,178977,121.330879287378,"04",2018-04-01
"Georgia","2018-05",2018,5,243000,76190,166810,104.520818321376,"05",2018-05-01
"Georgia","2018-06",2018,6,240000,57194,182806,123.021326137136,"06",2018-06-01
"Georgia","2018-07",2018,7,235000,79319,155681,99.0592359990965,"07",2018-07-01
"Georgia","2018-08",2018,8,232000,75097,156903,102.184651754983,"08",2018-08-01
"Georgia","2018-09",2018,9,232000,66110,165890,111.294488611586,"09",2018-09-01
"Georgia","2019-01",2019,1,228000,70492,157508,105.535826755826,"01",2019-01-01
"Georgia","2019-10",2019,10,236000,94105,141895,85.9696157283289,"10",2019-10-01
"Georgia","2019-11",2019,11,237000,86799,150201,92.7742210445369,"11",2019-11-01
"Georgia","2019-12",2019,12,228000,92428,135572,84.6193216572834,"12",2019-12-01
"Georgia","2019-02",2019,2,227000,70933,156067,104.76650790614,"02",2019-02-01
"Georgia","2019-03",2019,3,235000,89133,145867,90.0044117692429,"03",2019-03-01
"Georgia","2019-04",2019,4,248000,82387,165613,100.253944616465,"04",2019-04-01
"Georgia","2019-05",2019,5,246000,91824,154176,91.2759306621199,"05",2019-05-01
"Georgia","2019-06",2019,6,229000,78017,150983,98.3548142285281,"06",2019-06-01
"Georgia","2019-07",2019,7,216000,65580,150420,106.839974430002,"07",2019-07-01
"Georgia","2019-08",2019,8,218000,90510,127490,82.6488606528151,"08",2019-08-01
"Georgia","2019-09",2019,9,229000,95662,133338,82.1395790083225,"09",2019-09-01
"Hawaii","2010-01",2010,1,12000,1142,10858,165.241211383351,"01",2010-01-01
"Hawaii","2010-10",2010,10,15000,4462,10538,108.293083958483,"10",2010-10-01
"Hawaii","2010-11",2010,11,16000,7144,8856,76.529554096094,"11",2010-11-01
"Hawaii","2010-12",2010,12,15000,5518,9482,92.4261623939955,"12",2010-12-01
"Hawaii","2010-02",2010,2,13000,4428,8572,98.3704383750287,"02",2010-02-01
"Hawaii","2010-03",2010,3,14000,3246,10754,124.712976922185,"03",2010-03-01
"Hawaii","2010-04",2010,4,13000,3582,9418,113.593052707755,"04",2010-04-01
"Hawaii","2010-05",2010,5,13000,6230,6770,70.4108164326573,"05",2010-05-01
"Hawaii","2010-06",2010,6,13000,3272,9728,119.567354965585,"06",2010-06-01
"Hawaii","2010-07",2010,7,13000,5072,7928,87.7379371403276,"07",2010-07-01
"Hawaii","2010-08",2010,8,13000,4499,8501,97.1598377050117,"08",2010-08-01
"Hawaii","2010-09",2010,9,14000,4003,9997,111.059267899794,"09",2010-09-01
"Hawaii","2011-01",2011,1,15000,5675,9325,90.2055622732769,"01",2011-01-01
"Hawaii","2011-10",2011,10,17000,7536,9464,77.1437887186175,"10",2011-10-01
"Hawaii","2011-11",2011,11,17000,4933,12067,110.035106916519,"11",2011-11-01
"Hawaii","2011-12",2011,12,17000,7744,9256,74.8140963465891,"12",2011-12-01
"Hawaii","2011-02",2011,2,17000,3113,13887,138.089792671407,"02",2011-02-01
"Hawaii","2011-03",2011,3,17000,7978,9022,72.2395708223236,"03",2011-03-01
"Hawaii","2011-04",2011,4,17000,6179,10821,93.3689977997325,"04",2011-04-01
"Hawaii","2011-05",2011,5,16000,9079,6921,55.1935882610949,"05",2011-05-01
"Hawaii","2011-06",2011,6,16000,8674,7326,59.3823457890897,"06",2011-06-01
"Hawaii","2011-07",2011,7,17000,8257,8743,69.2322920378509,"07",2011-07-01
"Hawaii","2011-08",2011,8,17000,7077,9923,82.4272126926112,"08",2011-08-01
"Hawaii","2011-09",2011,9,18000,7364,10636,83.8668979656206,"09",2011-09-01
"Hawaii","2012-01",2012,1,16000,11078,4922,36.3542359110717,"01",2012-01-01
"Hawaii","2012-10",2012,10,17000,6156,10844,93.6603903955778,"10",2012-10-01
"Hawaii","2012-11",2012,11,17000,4982,12018,109.344008734419,"11",2012-11-01
"Hawaii","2012-12",2012,12,17000,10157,6843,50.3958463747837,"12",2012-12-01
"Hawaii","2012-02",2012,2,17000,9549,7451,56.1301743945158,"02",2012-02-01
"Hawaii","2012-03",2012,3,17000,9960,7040,52.2255192878338,"03",2012-03-01
"Hawaii","2012-04",2012,4,17000,8101,8899,70.905541611888,"04",2012-04-01
"Hawaii","2012-05",2012,5,16000,11685,4315,31.1721148636446,"05",2012-05-01
"Hawaii","2012-06",2012,6,17000,7632,9368,76.0636570315037,"06",2012-06-01
"Hawaii","2012-07",2012,7,18000,9831,8169,58.7043225180554,"07",2012-07-01
"Hawaii","2012-08",2012,8,18000,4745,13255,116.553088590899,"08",2012-08-01
"Hawaii","2012-09",2012,9,17000,4412,12588,117.578927704091,"09",2012-09-01
"Hawaii","2013-01",2013,1,17000,5767,11233,98.6779110115518,"01",2013-01-01
"Hawaii","2013-10",2013,10,16000,6000,10000,90.9090909090909,"10",2013-10-01
"Hawaii","2013-11",2013,11,16000,6446,9554,85.128753452731,"11",2013-11-01
"Hawaii","2013-12",2013,12,16000,5436,10564,98.5631647695465,"12",2013-12-01
"Hawaii","2013-02",2013,2,18000,5315,12685,108.81406819644,"02",2013-02-01
"Hawaii","2013-03",2013,3,18000,4582,13418,118.838012576388,"03",2013-03-01
"Hawaii","2013-04",2013,4,18000,2852,15148,145.290619604834,"04",2013-04-01
"Hawaii","2013-05",2013,5,16000,3620,12380,126.197757390418,"05",2013-05-01
"Hawaii","2013-06",2013,6,16000,5052,10948,104.009120273608,"06",2013-06-01
"Hawaii","2013-07",2013,7,17000,8873,8127,62.822247130213,"07",2013-07-01
"Hawaii","2013-08",2013,8,16000,6260,9740,87.5112309074573,"08",2013-08-01
"Hawaii","2013-09",2013,9,16000,5519,10481,97.4115897578884,"09",2013-09-01
"Hawaii","2014-01",2014,1,16000,6948,9052,78.8914066585323,"01",2014-01-01
"Hawaii","2014-10",2014,10,19000,6326,12674,100.086867251046,"10",2014-10-01
"Hawaii","2014-11",2014,11,18000,6410,11590,94.9610815239656,"11",2014-11-01
"Hawaii","2014-12",2014,12,17000,4474,12526,116.662009872404,"12",2014-12-01
"Hawaii","2014-02",2014,2,17000,6441,10559,90.0900132246918,"02",2014-02-01
"Hawaii","2014-03",2014,3,18000,6687,11313,91.6514764855997,"03",2014-03-01
"Hawaii","2014-04",2014,4,18000,7047,10953,87.4595759971254,"04",2014-04-01
"Hawaii","2014-05",2014,5,18000,6033,11967,99.5880664086881,"05",2014-05-01
"Hawaii","2014-06",2014,6,19000,5006,13994,116.58751978672,"06",2014-06-01
"Hawaii","2014-07",2014,7,18000,5117,12883,111.459099364104,"07",2014-07-01
"Hawaii","2014-08",2014,8,19000,6811,12189,94.4481035217543,"08",2014-08-01
"Hawaii","2014-09",2014,9,20000,6426,13574,102.732157723454,"09",2014-09-01
"Hawaii","2015-01",2015,1,19000,4489,14511,123.555706926647,"01",2015-01-01
"Hawaii","2015-10",2015,10,21000,5292,15708,119.488817891374,"10",2015-10-01
"Hawaii","2015-11",2015,11,20000,4456,15544,127.118089630357,"11",2015-11-01
"Hawaii","2015-12",2015,12,20000,3805,16195,136.063852131905,"12",2015-12-01
"Hawaii","2015-02",2015,2,20000,3668,16332,138.009126246409,"02",2015-02-01
"Hawaii","2015-03",2015,3,21000,4616,16384,127.92004996877,"03",2015-03-01
"Hawaii","2015-04",2015,4,20000,5700,14300,111.284046692607,"04",2015-04-01
"Hawaii","2015-05",2015,5,19000,5190,13810,114.17941298057,"05",2015-05-01
"Hawaii","2015-06",2015,6,18000,4669,13331,117.614363227315,"06",2015-06-01
"Hawaii","2015-07",2015,7,19000,6449,12551,98.6364886636017,"07",2015-07-01
"Hawaii","2015-08",2015,8,20000,6454,13546,102.411733575263,"08",2015-08-01
"Hawaii","2015-09",2015,9,22000,5006,16994,125.853514033918,"09",2015-09-01
"Hawaii","2016-01",2016,1,21000,5663,15337,115.043318456288,"01",2016-01-01
"Hawaii","2016-10",2016,10,26000,7078,18922,114.408368099643,"10",2016-10-01
"Hawaii","2016-11",2016,11,23000,5831,17169,119.100967708369,"11",2016-11-01
"Hawaii","2016-12",2016,12,22000,5837,16163,116.126019326795,"12",2016-12-01
"Hawaii","2016-02",2016,2,23000,5059,17941,127.880537438968,"02",2016-02-01
"Hawaii","2016-03",2016,3,23000,6732,16268,109.430916184582,"03",2016-03-01
"Hawaii","2016-04",2016,4,23000,5569,17431,122.027372326648,"04",2016-04-01
"Hawaii","2016-05",2016,5,22000,5298,16702,122.367939043153,"05",2016-05-01
"Hawaii","2016-06",2016,6,23000,6137,16863,115.74973401517,"06",2016-06-01
"Hawaii","2016-07",2016,7,23000,6722,16278,109.535024560931,"07",2016-07-01
"Hawaii","2016-08",2016,8,27000,6108,20892,126.205146792316,"08",2016-08-01
"Hawaii","2016-09",2016,9,28000,7418,20582,116.223389237111,"09",2016-09-01
"Hawaii","2017-01",2017,1,26000,6972,19028,115.41914351571,"01",2017-01-01
"Hawaii","2017-10",2017,10,28000,5541,22459,133.919680391163,"10",2017-10-01
"Hawaii","2017-11",2017,11,28000,5041,22959,138.972791380406,"11",2017-11-01
"Hawaii","2017-12",2017,12,27000,4807,22193,139.547898261389,"12",2017-12-01
"Hawaii","2017-02",2017,2,26000,6787,19213,117.198889803886,"02",2017-02-01
"Hawaii","2017-03",2017,3,26000,8902,17098,97.9771932840525,"03",2017-03-01
"Hawaii","2017-04",2017,4,25000,7426,17574,108.394498242151,"04",2017-04-01
"Hawaii","2017-05",2017,5,24000,7900,16100,100.940438871473,"05",2017-05-01
"Hawaii","2017-06",2017,6,25000,7729,17271,105.539429863424,"06",2017-06-01
"Hawaii","2017-07",2017,7,26000,7668,18332,108.898657478912,"07",2017-07-01
"Hawaii","2017-08",2017,8,27000,6341,20659,123.925497135659,"08",2017-08-01
"Hawaii","2017-09",2017,9,28000,5699,22301,132.354075788599,"09",2017-09-01
"Hawaii","2018-01",2018,1,27000,5466,21534,132.655701349104,"01",2018-01-01
"Hawaii","2018-10",2018,10,30000,10222,19778,98.3441897469047,"10",2018-10-01
"Hawaii","2018-11",2018,11,30000,11070,18930,92.1840759678597,"11",2018-11-01
"Hawaii","2018-12",2018,12,31000,10034,20966,102.188429107569,"12",2018-12-01
"Hawaii","2018-02",2018,2,27000,6495,20505,122.43618450515,"02",2018-02-01
"Hawaii","2018-03",2018,3,27000,7486,19514,113.170561967175,"03",2018-03-01
"Hawaii","2018-04",2018,4,27000,9176,17824,98.5404688191066,"04",2018-04-01
"Hawaii","2018-05",2018,5,26000,11302,14698,78.805425982521,"05",2018-05-01
"Hawaii","2018-06",2018,6,26000,8850,17150,98.4218077474892,"06",2018-06-01
"Hawaii","2018-07",2018,7,27000,11640,15360,79.5031055900621,"07",2018-07-01
"Hawaii","2018-08",2018,8,28000,11307,16693,84.936525300837,"08",2018-08-01
"Hawaii","2018-09",2018,9,30000,9092,20908,106.968177632252,"09",2018-09-01
"Hawaii","2019-01",2019,1,31000,8231,22769,116.076572098596,"01",2019-01-01
"Hawaii","2019-10",2019,10,30000,11707,18293,87.7214856019373,"10",2019-10-01
"Hawaii","2019-11",2019,11,30000,10669,19331,95.0650372519609,"11",2019-11-01
"Hawaii","2019-12",2019,12,30000,11045,18955,92.3620416615909,"12",2019-12-01
"Hawaii","2019-02",2019,2,29000,8890,20110,106.149379783584,"02",2019-02-01
"Hawaii","2019-03",2019,3,29000,11838,17162,84.049169890788,"03",2019-03-01
"Hawaii","2019-04",2019,4,28000,9030,18970,102.457466918715,"04",2019-04-01
"Hawaii","2019-05",2019,5,28000,11269,16731,85.2122539407675,"05",2019-05-01
"Hawaii","2019-06",2019,6,28000,9825,18175,96.1004626569729,"06",2019-06-01
"Hawaii","2019-07",2019,7,29000,8225,20775,111.618535930154,"07",2019-07-01
"Hawaii","2019-08",2019,8,29000,8494,20506,109.382834586867,"08",2019-08-01
"Hawaii","2019-09",2019,9,30000,11371,18629,90.0582533658843,"09",2019-09-01
"Idaho","2010-01",2010,1,12000,1241,10759,162.510384412053,"01",2010-01-01
"Idaho","2010-10",2010,10,17000,5277,11723,105.247564752884,"10",2010-10-01
"Idaho","2010-11",2010,11,17000,3738,13262,127.900472562446,"11",2010-11-01
"Idaho","2010-12",2010,12,16000,5342,10658,99.8781744916128,"12",2010-12-01
"Idaho","2010-02",2010,2,13000,2291,10709,140.069321823295,"02",2010-02-01
"Idaho","2010-03",2010,3,14000,2872,11128,131.910858226648,"03",2010-03-01
"Idaho","2010-04",2010,4,17000,4105,12895,122.198531153755,"04",2010-04-01
"Idaho","2010-05",2010,5,19000,6320,12680,100.157977883096,"05",2010-05-01
"Idaho","2010-06",2010,6,20000,3699,16301,137.566985948774,"06",2010-06-01
"Idaho","2010-07",2010,7,19000,4356,14644,125.398184620654,"07",2010-07-01
"Idaho","2010-08",2010,8,18000,3797,14203,130.320686332982,"08",2010-08-01
"Idaho","2010-09",2010,9,17000,4179,12821,121.072760753577,"09",2010-09-01
"Idaho","2011-01",2011,1,14000,4565,9435,101.642876380285,"01",2011-01-01
"Idaho","2011-10",2011,10,19000,5886,13114,105.392590211364,"10",2011-10-01
"Idaho","2011-11",2011,11,19000,5438,13562,110.991079466405,"11",2011-11-01
"Idaho","2011-12",2011,12,17000,5640,11360,100.353356890459,"12",2011-12-01
"Idaho","2011-02",2011,2,14000,3159,10841,126.359344950172,"02",2011-02-01
"Idaho","2011-03",2011,3,15000,7159,7841,70.7703416219143,"03",2011-03-01
"Idaho","2011-04",2011,4,18000,4667,13333,117.642387611947,"04",2011-04-01
"Idaho","2011-05",2011,5,19000,5397,13603,111.513710702136,"05",2011-05-01
"Idaho","2011-06",2011,6,21000,6444,14556,106.077831219939,"06",2011-06-01
"Idaho","2011-07",2011,7,20000,6210,13790,105.227012590614,"07",2011-07-01
"Idaho","2011-08",2011,8,20000,6121,13879,106.266988247004,"08",2011-08-01
"Idaho","2011-09",2011,9,19000,6414,12586,99.0477689462501,"09",2011-09-01
"Idaho","2012-01",2012,1,16000,6288,9712,87.1500358937545,"01",2012-01-01
"Idaho","2012-10",2012,10,19000,7392,11608,87.9660503182783,"10",2012-10-01
"Idaho","2012-11",2012,11,19000,6063,12937,103.235845668914,"11",2012-11-01
"Idaho","2012-12",2012,12,18000,10972,7028,48.5158083666989,"12",2012-12-01
"Idaho","2012-02",2012,2,16000,11266,4734,34.7245653927969,"02",2012-02-01
"Idaho","2012-03",2012,3,17000,8048,8952,71.4787607793037,"03",2012-03-01
"Idaho","2012-04",2012,4,19000,7065,11935,91.5787454440821,"04",2012-04-01
"Idaho","2012-05",2012,5,21000,10120,10880,69.9228791773779,"05",2012-05-01
"Idaho","2012-06",2012,6,23000,6297,16703,114.025326825272,"06",2012-06-01
"Idaho","2012-07",2012,7,22000,6398,15602,109.880977533629,"07",2012-07-01
"Idaho","2012-08",2012,8,21000,8036,12964,89.2960462873674,"08",2012-08-01
"Idaho","2012-09",2012,9,19000,7154,11846,90.586525961612,"09",2012-09-01
"Idaho","2013-01",2013,1,17000,8328,8672,68.4775742261529,"01",2013-01-01
"Idaho","2013-10",2013,10,22000,10464,11536,71.0694923607688,"10",2013-10-01
"Idaho","2013-11",2013,11,21000,8203,12797,87.6416806492484,"11",2013-11-01
"Idaho","2013-12",2013,12,20000,7336,12664,92.654375182909,"12",2013-12-01
"Idaho","2013-02",2013,2,18000,7334,10666,84.2030472882293,"02",2013-02-01
"Idaho","2013-03",2013,3,20000,9138,10862,74.555563182099,"03",2013-03-01
"Idaho","2013-04",2013,4,24000,4558,19442,136.157994257301,"04",2013-04-01
"Idaho","2013-05",2013,5,26000,5473,20527,130.441966129698,"05",2013-05-01
"Idaho","2013-06",2013,6,26000,8334,17666,102.906739674958,"06",2013-06-01
"Idaho","2013-07",2013,7,23000,12914,10086,56.1675112769394,"07",2013-07-01
"Idaho","2013-08",2013,8,22000,12633,9367,54.0929171599342,"08",2013-08-01
"Idaho","2013-09",2013,9,21000,9773,11227,72.9665615962045,"09",2013-09-01
"Idaho","2014-01",2014,1,20000,9937,10063,67.2278451414637,"01",2014-01-01
"Idaho","2014-10",2014,10,30000,10863,19137,93.6641949930255,"10",2014-10-01
"Idaho","2014-11",2014,11,27000,6796,20204,119.564445496508,"11",2014-11-01
"Idaho","2014-12",2014,12,25000,7254,17746,110.03906492218,"12",2014-12-01
"Idaho","2014-02",2014,2,23000,9084,13916,86.7472883680339,"02",2014-02-01
"Idaho","2014-03",2014,3,24000,10415,13585,78.9481330815052,"03",2014-03-01
"Idaho","2014-04",2014,4,27000,12069,14931,76.43400138217,"04",2014-04-01
"Idaho","2014-05",2014,5,29000,11022,17978,89.8405876767778,"05",2014-05-01
"Idaho","2014-06",2014,6,32000,9924,22076,105.314378399008,"06",2014-06-01
"Idaho","2014-07",2014,7,31000,8206,22794,116.278120695812,"07",2014-07-01
"Idaho","2014-08",2014,8,31000,12331,18669,86.1692552675913,"08",2014-08-01
"Idaho","2014-09",2014,9,30000,10574,19426,95.7559027948933,"09",2014-09-01
"Idaho","2015-01",2015,1,24000,7169,16831,107.998331675703,"01",2015-01-01
"Idaho","2015-10",2015,10,28000,7612,20388,114.500730090981,"10",2015-10-01
"Idaho","2015-11",2015,11,27000,6213,20787,125.173877698492,"11",2015-11-01
"Idaho","2015-12",2015,12,25000,6015,18985,122.42463324198,"12",2015-12-01
"Idaho","2015-02",2015,2,26000,6730,19270,117.751298502903,"02",2015-02-01
"Idaho","2015-03",2015,3,30000,8439,21561,112.182939202373,"03",2015-03-01
"Idaho","2015-04",2015,4,32000,9563,22437,107.966219955249,"04",2015-04-01
"Idaho","2015-05",2015,5,33000,10056,22944,106.577480490524,"05",2015-05-01
"Idaho","2015-06",2015,6,32000,8029,23971,119.768168078143,"06",2015-06-01
"Idaho","2015-07",2015,7,32000,8768,23232,113.971742543171,"07",2015-07-01
"Idaho","2015-08",2015,8,30000,8640,21360,110.55900621118,"08",2015-08-01
"Idaho","2015-09",2015,9,31000,7258,23742,124.115217732239,"09",2015-09-01
"Idaho","2016-01",2016,1,24000,7773,16227,102.143329241809,"01",2016-01-01
"Idaho","2016-10",2016,10,31000,9259,21741,108.005663329939,"10",2016-10-01
"Idaho","2016-11",2016,11,30000,7648,22352,118.742031449214,"11",2016-11-01
"Idaho","2016-12",2016,12,28000,7960,20040,111.457174638487,"12",2016-12-01
"Idaho","2016-02",2016,2,26000,7316,18684,112.162324408693,"02",2016-02-01
"Idaho","2016-03",2016,3,29000,11123,17877,89.1109837250455,"03",2016-03-01
"Idaho","2016-04",2016,4,35000,9992,25008,111.166429587482,"04",2016-04-01
"Idaho","2016-05",2016,5,38000,8575,29425,126.355340848094,"05",2016-05-01
"Idaho","2016-06",2016,6,40000,8578,31422,129.367203260735,"06",2016-06-01
"Idaho","2016-07",2016,7,37000,8946,28054,122.117268097332,"07",2016-07-01
"Idaho","2016-08",2016,8,35000,8180,26820,124.22417786012,"08",2016-08-01
"Idaho","2016-09",2016,9,33000,9949,23051,107.341265221542,"09",2016-09-01
"Idaho","2017-01",2017,1,29000,8705,20295,107.651505105424,"01",2017-01-01
"Idaho","2017-10",2017,10,34000,6128,27872,138.915470494418,"10",2017-10-01
"Idaho","2017-11",2017,11,33000,6446,26554,134.634690462911,"11",2017-11-01
"Idaho","2017-12",2017,12,32000,4520,27480,150.492880613363,"12",2017-12-01
"Idaho","2017-02",2017,2,29000,9669,19331,99.9818976441077,"02",2017-02-01
"Idaho","2017-03",2017,3,31000,11045,19955,94.9221072660245,"03",2017-03-01
"Idaho","2017-04",2017,4,33000,8251,24749,119.9922426123,"04",2017-04-01
"Idaho","2017-05",2017,5,35000,10293,24707,109.098536197646,"05",2017-05-01
"Idaho","2017-06",2017,6,37000,9548,27452,117.951362034889,"06",2017-06-01
"Idaho","2017-07",2017,7,35000,8482,26518,121.972310381307,"07",2017-07-01
"Idaho","2017-08",2017,8,35000,6939,28061,133.818164476978,"08",2017-08-01
"Idaho","2017-09",2017,9,33000,6356,26644,135.399939018193,"09",2017-09-01
"Idaho","2018-01",2018,1,30000,7176,22824,122.788896061975,"01",2018-01-01
"Idaho","2018-10",2018,10,40000,8173,31827,132.136258900214,"10",2018-10-01
"Idaho","2018-11",2018,11,38000,7007,30993,137.725242740018,"11",2018-11-01
"Idaho","2018-12",2018,12,37000,7224,29776,134.65991316932,"12",2018-12-01
"Idaho","2018-02",2018,2,31000,7324,23676,123.55703997495,"02",2018-02-01
"Idaho","2018-03",2018,3,33000,9011,23989,114.203422913047,"03",2018-03-01
"Idaho","2018-04",2018,4,37000,10403,26597,112.216526380187,"04",2018-04-01
"Idaho","2018-05",2018,5,39000,10641,28359,114.256360669608,"05",2018-05-01
"Idaho","2018-06",2018,6,43000,8663,34337,132.92685287343,"06",2018-06-01
"Idaho","2018-07",2018,7,42000,10165,31835,122.055017732196,"07",2018-07-01
"Idaho","2018-08",2018,8,42000,8632,33368,131.805972507505,"08",2018-08-01
"Idaho","2018-09",2018,9,41000,9445,31555,125.106551689959,"09",2018-09-01
"Idaho","2019-01",2019,1,35000,7100,27900,132.541567695962,"01",2019-01-01
"Idaho","2019-10",2019,10,38000,13398,24602,95.7313514144519,"10",2019-10-01
"Idaho","2019-11",2019,11,37000,15238,21762,83.318656916421,"11",2019-11-01
"Idaho","2019-12",2019,12,35000,13918,21082,86.1932213091296,"12",2019-12-01
"Idaho","2019-02",2019,2,37000,6824,30176,137.714494341,"02",2019-02-01
"Idaho","2019-03",2019,3,38000,13067,24933,97.6481876750152,"03",2019-03-01
"Idaho","2019-04",2019,4,40000,10519,29481,116.712524000871,"04",2019-04-01
"Idaho","2019-05",2019,5,42000,10654,31346,119.064078702473,"05",2019-05-01
"Idaho","2019-06",2019,6,43000,9875,33125,125.295508274232,"06",2019-06-01
"Idaho","2019-07",2019,7,44000,7748,36252,140.109762696143,"07",2019-07-01
"Idaho","2019-08",2019,8,42000,11104,30896,116.360349502862,"08",2019-08-01
"Idaho","2019-09",2019,9,39000,12255,26745,104.360550190225,"09",2019-09-01
"Illinois","2010-01",2010,1,84000,7424,76576,167.518375918796,"01",2010-01-01
"Illinois","2010-10",2010,10,120000,54102,65898,75.7004514594893,"10",2010-10-01
"Illinois","2010-11",2010,11,124000,39701,84299,102.99142949646,"11",2010-11-01
"Illinois","2010-12",2010,12,122000,46616,75384,89.4150021350287,"12",2010-12-01
"Illinois","2010-02",2010,2,90000,27735,62265,105.771435851701,"02",2010-02-01
"Illinois","2010-03",2010,3,99000,33091,65909,99.7933242991574,"03",2010-03-01
"Illinois","2010-04",2010,4,106000,32851,73149,105.363303109088,"04",2010-04-01
"Illinois","2010-05",2010,5,116000,41547,74453,94.5152875015075,"05",2010-05-01
"Illinois","2010-06",2010,6,119000,33760,85240,111.599895260539,"06",2010-06-01
"Illinois","2010-07",2010,7,119000,44929,74071,90.3696112341319,"07",2010-07-01
"Illinois","2010-08",2010,8,116000,43808,72192,90.3484181017221,"08",2010-08-01
"Illinois","2010-09",2010,9,113000,46824,66176,82.8110922014216,"09",2010-09-01
"Illinois","2011-01",2011,1,120000,46882,73118,87.628384127707,"01",2011-01-01
"Illinois","2011-10",2011,10,155000,44004,110996,111.55152660248,"10",2011-10-01
"Illinois","2011-11",2011,11,148000,41900,106100,111.743022643497,"11",2011-11-01
"Illinois","2011-12",2011,12,130000,40014,89986,105.857164704083,"12",2011-12-01
"Illinois","2011-02",2011,2,117000,37741,79259,102.440852779806,"02",2011-02-01
"Illinois","2011-03",2011,3,131000,59251,71749,75.4256219415404,"03",2011-03-01
"Illinois","2011-04",2011,4,135000,44965,90035,100.058344678132,"04",2011-04-01
"Illinois","2011-05",2011,5,142000,62984,79016,77.0947976427428,"05",2011-05-01
"Illinois","2011-06",2011,6,143000,63076,79924,77.5674993691648,"06",2011-06-01
"Illinois","2011-07",2011,7,146000,49419,96581,98.8450457734407,"07",2011-07-01
"Illinois","2011-08",2011,8,147000,44659,102341,106.794880490872,"08",2011-08-01
"Illinois","2011-09",2011,9,152000,45360,106640,108.06647750304,"09",2011-09-01
"Illinois","2012-01",2012,1,121000,53440,67560,77.459298326072,"01",2012-01-01
"Illinois","2012-10",2012,10,170000,41457,128543,121.578382366155,"10",2012-10-01
"Illinois","2012-11",2012,11,159000,38272,120728,122.397501926274,"11",2012-11-01
"Illinois","2012-12",2012,12,150000,47228,102772,104.21643985641,"12",2012-12-01
"Illinois","2012-02",2012,2,133000,50182,82818,90.4215479686869,"02",2012-02-01
"Illinois","2012-03",2012,3,152000,59479,92521,87.4989951720975,"03",2012-03-01
"Illinois","2012-04",2012,4,159000,49241,109759,105.415360087591,"04",2012-04-01
"Illinois","2012-05",2012,5,163000,60209,102791,92.1029169970745,"05",2012-05-01
"Illinois","2012-06",2012,6,156000,51590,104410,100.592514090274,"06",2012-06-01
"Illinois","2012-07",2012,7,156000,40297,115703,117.885652862754,"07",2012-07-01
"Illinois","2012-08",2012,8,157000,31126,125874,133.818823554426,"08",2012-08-01
"Illinois","2012-09",2012,9,164000,33424,130576,132.279763351973,"09",2012-09-01
"Illinois","2013-01",2013,1,140000,61834,78166,77.4557309472141,"01",2013-01-01
"Illinois","2013-10",2013,10,169000,87900,81100,63.1374075515765,"10",2013-10-01
"Illinois","2013-11",2013,11,170000,73026,96974,79.805452914503,"11",2013-11-01
"Illinois","2013-12",2013,12,162000,66610,95390,83.4521674467434,"12",2013-12-01
"Illinois","2013-02",2013,2,149000,55065,93935,92.0638031999608,"02",2013-02-01
"Illinois","2013-03",2013,3,156000,53289,102711,98.1523156974327,"03",2013-03-01
"Illinois","2013-04",2013,4,168000,40074,127926,122.962023126388,"04",2013-04-01
"Illinois","2013-05",2013,5,165000,51183,113817,105.296901236452,"05",2013-05-01
"Illinois","2013-06",2013,6,163000,81650,81350,66.5031677907214,"06",2013-06-01
"Illinois","2013-07",2013,7,150000,83920,66080,56.4979480164159,"07",2013-07-01
"Illinois","2013-08",2013,8,152000,89726,62274,51.5244533066364,"08",2013-08-01
"Illinois","2013-09",2013,9,155000,78345,76655,65.7010006642525,"09",2013-09-01
"Illinois","2014-01",2014,1,153000,86413,66587,55.6252166757862,"01",2014-01-01
"Illinois","2014-10",2014,10,227000,97384,129616,79.9151622768077,"10",2014-10-01
"Illinois","2014-11",2014,11,212000,79725,132275,90.6847201988174,"11",2014-11-01
"Illinois","2014-12",2014,12,202000,76146,125854,90.4949199341353,"12",2014-12-01
"Illinois","2014-02",2014,2,154000,73047,80953,71.3094645602012,"02",2014-02-01
"Illinois","2014-03",2014,3,168000,93495,74505,56.983881144955,"03",2014-03-01
"Illinois","2014-04",2014,4,191000,88332,102668,73.509658757321,"04",2014-04-01
"Illinois","2014-05",2014,5,211000,86810,124190,83.4021691682616,"05",2014-05-01
"Illinois","2014-06",2014,6,219000,77930,141070,95.01902805375,"06",2014-06-01
"Illinois","2014-07",2014,7,219000,68289,150711,104.919436525589,"07",2014-07-01
"Illinois","2014-08",2014,8,228000,93379,134621,83.7770980680132,"08",2014-08-01
"Illinois","2014-09",2014,9,229000,95206,133794,82.5364120343239,"09",2014-09-01
"Illinois","2015-01",2015,1,193000,78623,114377,84.2174631750625,"01",2015-01-01
"Illinois","2015-10",2015,10,233000,77186,155814,100.464882360906,"10",2015-10-01
"Illinois","2015-11",2015,11,229000,64247,164753,112.364661872074,"11",2015-11-01
"Illinois","2015-12",2015,12,227000,58063,168937,118.526080199815,"12",2015-12-01
"Illinois","2015-02",2015,2,199000,59477,139523,107.957768002569,"02",2015-02-01
"Illinois","2015-03",2015,3,213000,92531,120469,78.8587737414534,"03",2015-03-01
"Illinois","2015-04",2015,4,228000,75384,152616,100.609129024602,"04",2015-04-01
"Illinois","2015-05",2015,5,232000,83245,148755,94.3742168789354,"05",2015-05-01
"Illinois","2015-06",2015,6,228000,89801,138199,86.9720359596099,"06",2015-06-01
"Illinois","2015-07",2015,7,239000,88555,150445,91.8593823937965,"07",2015-07-01
"Illinois","2015-08",2015,8,237000,86895,150105,92.6874450053258,"08",2015-08-01
"Illinois","2015-09",2015,9,240000,76631,163369,103.192043735452,"09",2015-09-01
"Illinois","2016-01",2016,1,219000,80253,138747,92.7288949484216,"01",2016-01-01
"Illinois","2016-10",2016,10,218000,95211,122789,78.4065693733617,"10",2016-10-01
"Illinois","2016-11",2016,11,215000,88088,126912,83.7459747664045,"11",2016-11-01
"Illinois","2016-12",2016,12,210000,72894,137106,96.9310059598295,"12",2016-12-01
"Illinois","2016-02",2016,2,225000,70650,154350,104.41400304414,"02",2016-02-01
"Illinois","2016-03",2016,3,227000,79394,147606,96.3504507268419,"03",2016-03-01
"Illinois","2016-04",2016,4,232000,85021,146979,92.7250876124926,"04",2016-04-01
"Illinois","2016-05",2016,5,241000,76725,164275,103.407034385081,"05",2016-05-01
"Illinois","2016-06",2016,6,238000,94535,143465,86.2856541416693,"06",2016-06-01
"Illinois","2016-07",2016,7,242000,96285,145715,86.1492528489292,"07",2016-07-01
"Illinois","2016-08",2016,8,224000,88936,135064,86.3205256026791,"08",2016-08-01
"Illinois","2016-09",2016,9,223000,101879,121121,74.5637606616617,"09",2016-09-01
"Illinois","2017-01",2017,1,203000,79443,123557,87.4916354804332,"01",2017-01-01
"Illinois","2017-10",2017,10,275000,66493,208507,122.114948183418,"10",2017-10-01
"Illinois","2017-11",2017,11,265000,60530,204470,125.622830461094,"11",2017-11-01
"Illinois","2017-12",2017,12,239000,45144,193856,136.449124387634,"12",2017-12-01
"Illinois","2017-02",2017,2,209000,86677,122323,82.7409639572912,"02",2017-02-01
"Illinois","2017-03",2017,3,220000,102914,117086,72.5183795066179,"03",2017-03-01
"Illinois","2017-04",2017,4,230000,93748,136252,84.1716396703609,"04",2017-04-01
"Illinois","2017-05",2017,5,236000,90372,145628,89.2404985721814,"05",2017-05-01
"Illinois","2017-06",2017,6,248000,87229,160771,95.9171193423003,"06",2017-06-01
"Illinois","2017-07",2017,7,259000,83810,175190,102.208220296958,"07",2017-07-01
"Illinois","2017-08",2017,8,267000,83495,183505,104.711907445185,"08",2017-08-01
"Illinois","2017-09",2017,9,275000,71340,203660,117.606975804123,"09",2017-09-01
"Illinois","2018-01",2018,1,221000,62082,158918,112.277008075399,"01",2018-01-01
"Illinois","2018-10",2018,10,324000,104131,219869,102.711086092808,"10",2018-10-01
"Illinois","2018-11",2018,11,324000,87114,236886,115.241028036019,"11",2018-11-01
"Illinois","2018-12",2018,12,303000,88177,214823,109.834167141729,"12",2018-12-01
"Illinois","2018-02",2018,2,225000,63966,161034,111.455326924275,"02",2018-02-01
"Illinois","2018-03",2018,3,237000,84716,152284,94.6698330204279,"03",2018-03-01
"Illinois","2018-04",2018,4,256000,119290,136710,72.8556582909217,"04",2018-04-01
"Illinois","2018-05",2018,5,277000,158492,118508,54.4248803651961,"05",2018-05-01
"Illinois","2018-06",2018,6,304000,91594,212406,107.385855194973,"06",2018-06-01
"Illinois","2018-07",2018,7,310000,110488,199512,94.8954548048934,"07",2018-07-01
"Illinois","2018-08",2018,8,311000,102048,208952,101.175650287618,"08",2018-08-01
"Illinois","2018-09",2018,9,314000,87811,226189,112.584772442765,"09",2018-09-01
"Illinois","2019-01",2019,1,3e+05,94609,205391,104.098487363441,"01",2019-01-01
"Illinois","2019-10",2019,10,279000,120292,158708,79.4947056289633,"10",2019-10-01
"Illinois","2019-11",2019,11,275000,107857,167143,87.3135400423657,"11",2019-11-01
"Illinois","2019-12",2019,12,267000,143692,123308,60.0488930877641,"12",2019-12-01
"Illinois","2019-02",2019,2,296000,81946,214054,113.272266408429,"02",2019-02-01
"Illinois","2019-03",2019,3,314000,114123,199877,93.3736332782868,"03",2019-03-01
"Illinois","2019-04",2019,4,312000,89367,222633,110.937371532787,"04",2019-04-01
"Illinois","2019-05",2019,5,307000,115421,191579,90.7052442941994,"05",2019-05-01
"Illinois","2019-06",2019,6,296000,86741,209259,109.347574469419,"06",2019-06-01
"Illinois","2019-07",2019,7,283000,85173,197827,107.46415407974,"07",2019-07-01
"Illinois","2019-08",2019,8,277000,139573,137427,65.9797922572994,"08",2019-08-01
"Illinois","2019-09",2019,9,269000,121255,147745,75.7171592932826,"09",2019-09-01
"Indiana","2010-01",2010,1,47000,4590,42410,164.41170769529,"01",2010-01-01
"Indiana","2010-10",2010,10,54000,21909,32091,84.5512389835197,"10",2010-10-01
"Indiana","2010-11",2010,11,49000,16519,32481,99.1498649246783,"11",2010-11-01
"Indiana","2010-12",2010,12,48000,20262,27738,81.269227388591,"12",2010-12-01
"Indiana","2010-02",2010,2,48000,9526,38474,133.762124952196,"02",2010-02-01
"Indiana","2010-03",2010,3,52000,13714,38286,116.523115317893,"03",2010-03-01
"Indiana","2010-04",2010,4,49000,12869,36131,116.798396612197,"04",2010-04-01
"Indiana","2010-05",2010,5,53000,16519,36481,104.952602885542,"05",2010-05-01
"Indiana","2010-06",2010,6,51000,15600,35400,106.306306306306,"06",2010-06-01
"Indiana","2010-07",2010,7,55000,17250,37750,104.498269896194,"07",2010-07-01
"Indiana","2010-08",2010,8,58000,16506,41494,111.3843180415,"08",2010-08-01
"Indiana","2010-09",2010,9,57000,17661,39339,105.38031904207,"09",2010-09-01
"Indiana","2011-01",2011,1,51000,20321,30679,86.0307623280661,"01",2011-01-01
"Indiana","2011-10",2011,10,84000,18102,65898,129.082682023858,"10",2011-10-01
"Indiana","2011-11",2011,11,76000,15263,60737,133.103229129001,"11",2011-11-01
"Indiana","2011-12",2011,12,71000,16235,54765,125.557402418754,"12",2011-12-01
"Indiana","2011-02",2011,2,54000,15610,38390,110.300244217785,"02",2011-02-01
"Indiana","2011-03",2011,3,57000,28848,28152,65.5856863293263,"03",2011-03-01
"Indiana","2011-04",2011,4,63000,20320,42680,102.448391742679,"04",2011-04-01
"Indiana","2011-05",2011,5,66000,25598,40402,88.2158999104784,"05",2011-05-01
"Indiana","2011-06",2011,6,71000,19624,51376,113.382768361582,"06",2011-06-01
"Indiana","2011-07",2011,7,73000,22467,50533,105.864853823834,"07",2011-07-01
"Indiana","2011-08",2011,8,79000,19133,59867,122.011963355854,"08",2011-08-01
"Indiana","2011-09",2011,9,82000,16834,65166,131.869599530526,"09",2011-09-01
"Indiana","2012-01",2012,1,67000,18834,48166,112.230584616819,"01",2012-01-01
"Indiana","2012-10",2012,10,86000,20060,65940,124.344710541203,"10",2012-10-01
"Indiana","2012-11",2012,11,84000,19576,64424,124.399474781803,"11",2012-11-01
"Indiana","2012-12",2012,12,79000,19144,59856,121.975872187806,"12",2012-12-01
"Indiana","2012-02",2012,2,75000,21212,53788,111.811416455328,"02",2012-02-01
"Indiana","2012-03",2012,3,86000,24519,61481,111.258697599508,"03",2012-03-01
"Indiana","2012-04",2012,4,88000,17792,70208,132.728372655777,"04",2012-04-01
"Indiana","2012-05",2012,5,85000,20291,64709,122.914589091185,"05",2012-05-01
"Indiana","2012-06",2012,6,77000,18646,58354,122.020784977939,"06",2012-06-01
"Indiana","2012-07",2012,7,75000,19439,55561,117.665371297875,"07",2012-07-01
"Indiana","2012-08",2012,8,75000,16377,58623,128.310187465117,"08",2012-08-01
"Indiana","2012-09",2012,9,83000,15902,67098,135.68583041799,"09",2012-09-01
"Indiana","2013-01",2013,1,73000,28048,44952,88.9715778639854,"01",2013-01-01
"Indiana","2013-10",2013,10,87000,31099,55901,94.6680327521825,"10",2013-10-01
"Indiana","2013-11",2013,11,85000,29003,55997,98.2377656728332,"11",2013-11-01
"Indiana","2013-12",2013,12,78000,29605,48395,89.9493517959203,"12",2013-12-01
"Indiana","2013-02",2013,2,78000,21508,56492,113.542629738313,"02",2013-02-01
"Indiana","2013-03",2013,3,76000,22391,53609,108.971349005498,"03",2013-03-01
"Indiana","2013-04",2013,4,75000,16693,58307,127.17873774443,"04",2013-04-01
"Indiana","2013-05",2013,5,70000,21241,48759,106.879582643768,"05",2013-05-01
"Indiana","2013-06",2013,6,69000,33283,35717,69.8395627816939,"06",2013-06-01
"Indiana","2013-07",2013,7,73000,36579,36421,66.4744157183402,"07",2013-07-01
"Indiana","2013-08",2013,8,77000,48015,28985,46.3704355477343,"08",2013-08-01
"Indiana","2013-09",2013,9,81000,36809,44191,75.021432997479,"09",2013-09-01
"Indiana","2014-01",2014,1,74000,35201,38799,71.0597888297726,"01",2014-01-01
"Indiana","2014-10",2014,10,101000,35348,65652,96.3006424736703,"10",2014-10-01
"Indiana","2014-11",2014,11,102000,26993,75007,116.296233128929,"11",2014-11-01
"Indiana","2014-12",2014,12,101000,26379,74621,117.163739705917,"12",2014-12-01
"Indiana","2014-02",2014,2,69000,34079,34921,67.7557989503197,"02",2014-02-01
"Indiana","2014-03",2014,3,75000,34365,40635,74.310794129749,"03",2014-03-01
"Indiana","2014-04",2014,4,80000,33117,46883,82.8929338649363,"04",2014-04-01
"Indiana","2014-05",2014,5,88000,34692,53308,86.8972712157272,"05",2014-05-01
"Indiana","2014-06",2014,6,89000,27844,61156,104.67974393208,"06",2014-06-01
"Indiana","2014-07",2014,7,90000,24674,65326,113.933411235328,"07",2014-07-01
"Indiana","2014-08",2014,8,93000,31720,61280,98.2681205901219,"08",2014-08-01
"Indiana","2014-09",2014,9,95000,32823,62177,97.2860909226039,"09",2014-09-01
"Indiana","2015-01",2015,1,93000,25057,67943,115.102026986964,"01",2015-01-01
"Indiana","2015-10",2015,10,113000,31221,81779,113.407894828076,"10",2015-10-01
"Indiana","2015-11",2015,11,108000,26302,81698,121.663117451713,"11",2015-11-01
"Indiana","2015-12",2015,12,99000,25281,73719,118.632775725976,"12",2015-12-01
"Indiana","2015-02",2015,2,95000,20981,74019,127.639872048008,"02",2015-02-01
"Indiana","2015-03",2015,3,99000,28645,70355,110.235418543617,"03",2015-03-01
"Indiana","2015-04",2015,4,110000,30890,79110,112.300376179999,"04",2015-04-01
"Indiana","2015-05",2015,5,114000,34373,79627,107.333544512816,"05",2015-05-01
"Indiana","2015-06",2015,6,115000,33282,81718,110.219716486155,"06",2015-06-01
"Indiana","2015-07",2015,7,113000,37192,75808,100.948119740066,"07",2015-07-01
"Indiana","2015-08",2015,8,109000,32724,76276,107.640202082922,"08",2015-08-01
"Indiana","2015-09",2015,9,113000,30863,82137,114.187803674329,"09",2015-09-01
"Indiana","2016-01",2016,1,92000,32890,59110,94.6593001841621,"01",2016-01-01
"Indiana","2016-10",2016,10,114000,43973,70027,88.6569223854709,"10",2016-10-01
"Indiana","2016-11",2016,11,109000,34759,74241,103.285359525317,"11",2016-11-01
"Indiana","2016-12",2016,12,105000,29372,75628,112.565117732861,"12",2016-12-01
"Indiana","2016-02",2016,2,101000,29704,71296,109.095360509242,"02",2016-02-01
"Indiana","2016-03",2016,3,112000,32679,79321,109.651020535116,"03",2016-03-01
"Indiana","2016-04",2016,4,118000,35560,82440,107.371711383173,"04",2016-04-01
"Indiana","2016-05",2016,5,119000,32827,86173,113.514723995073,"05",2016-05-01
"Indiana","2016-06",2016,6,115000,38968,76032,98.7633794035124,"06",2016-06-01
"Indiana","2016-07",2016,7,119000,40021,78979,99.3315348287333,"07",2016-07-01
"Indiana","2016-08",2016,8,118000,37606,80394,103.330205776127,"08",2016-08-01
"Indiana","2016-09",2016,9,122000,49529,72471,84.499997085041,"09",2016-09-01
"Indiana","2017-01",2017,1,99000,33821,65179,98.1456245623809,"01",2017-01-01
"Indiana","2017-10",2017,10,149000,28289,120711,136.174269131193,"10",2017-10-01
"Indiana","2017-11",2017,11,146000,26260,119740,139.022407987925,"11",2017-11-01
"Indiana","2017-12",2017,12,131000,21222,109778,144.234079173838,"12",2017-12-01
"Indiana","2017-02",2017,2,102000,34824,67176,98.1932994211542,"02",2017-02-01
"Indiana","2017-03",2017,3,110000,47073,62927,80.1245280856672,"03",2017-03-01
"Indiana","2017-04",2017,4,131000,35316,95684,115.062892325453,"04",2017-04-01
"Indiana","2017-05",2017,5,133000,36685,96315,113.522114506291,"05",2017-05-01
"Indiana","2017-06",2017,6,131000,37672,93328,110.662113450958,"06",2017-06-01
"Indiana","2017-07",2017,7,122000,36747,85253,107.407384076549,"07",2017-07-01
"Indiana","2017-08",2017,8,129000,38625,90375,107.829977628635,"08",2017-08-01
"Indiana","2017-09",2017,9,144000,31733,112267,127.769969214661,"09",2017-09-01
"Indiana","2018-01",2018,1,127000,29006,97994,125.628501467892,"01",2018-01-01
"Indiana","2018-10",2018,10,171000,50143,120857,109.302125773821,"10",2018-10-01
"Indiana","2018-11",2018,11,165000,43380,121620,116.729052692197,"11",2018-11-01
"Indiana","2018-12",2018,12,164000,41317,122683,119.505934725327,"12",2018-12-01
"Indiana","2018-02",2018,2,138000,31578,106422,125.513922796589,"02",2018-02-01
"Indiana","2018-03",2018,3,164000,39061,124939,123.055633528841,"03",2018-03-01
"Indiana","2018-04",2018,4,185000,37291,147709,132.896968388284,"04",2018-04-01
"Indiana","2018-05",2018,5,192000,54407,137593,111.679457158279,"05",2018-05-01
"Indiana","2018-06",2018,6,184000,36750,147250,133.408833522084,"06",2018-06-01
"Indiana","2018-07",2018,7,176000,49057,126943,112.809643779132,"07",2018-07-01
"Indiana","2018-08",2018,8,179000,45617,133383,118.764830800874,"08",2018-08-01
"Indiana","2018-09",2018,9,173000,41753,131247,122.230655683506,"09",2018-09-01
"Indiana","2019-01",2019,1,162000,45257,116743,112.655302354082,"01",2019-01-01
"Indiana","2019-10",2019,10,163000,52676,110324,102.305309816577,"10",2019-10-01
"Indiana","2019-11",2019,11,155000,51844,103156,99.7428013382066,"11",2019-11-01
"Indiana","2019-12",2019,12,140000,67192,72808,70.2807058187575,"12",2019-12-01
"Indiana","2019-02",2019,2,160000,40319,119681,119.490412791597,"02",2019-02-01
"Indiana","2019-03",2019,3,162000,60413,101587,91.3498761313412,"03",2019-03-01
"Indiana","2019-04",2019,4,173000,44282,128718,118.480131810274,"04",2019-04-01
"Indiana","2019-05",2019,5,173000,58469,114531,98.9601199296666,"05",2019-05-01
"Indiana","2019-06",2019,6,173000,43619,129381,119.454895461617,"06",2019-06-01
"Indiana","2019-07",2019,7,163000,40491,122509,120.407290740131,"07",2019-07-01
"Indiana","2019-08",2019,8,162000,62612,99388,88.4974979075027,"08",2019-08-01
"Indiana","2019-09",2019,9,160000,55900,104100,96.4335340435387,"09",2019-09-01
"Iowa","2010-01",2010,1,28000,2176,25824,171.155885471898,"01",2010-01-01
"Iowa","2010-10",2010,10,30000,14603,15397,69.0401990897473,"10",2010-10-01
"Iowa","2010-11",2010,11,31000,10925,20075,95.7662492546213,"11",2010-11-01
"Iowa","2010-12",2010,12,31000,14580,16420,72.0491443615621,"12",2010-12-01
"Iowa","2010-02",2010,2,28000,5156,22844,137.79708046809,"02",2010-02-01
"Iowa","2010-03",2010,3,32000,10730,21270,99.5553475310087,"03",2010-03-01
"Iowa","2010-04",2010,4,35000,9218,25782,116.61314396852,"04",2010-04-01
"Iowa","2010-05",2010,5,37000,11129,25871,107.506908516695,"05",2010-05-01
"Iowa","2010-06",2010,6,34000,11511,22489,98.8288545626332,"06",2010-06-01
"Iowa","2010-07",2010,7,32000,11954,20046,91.2135414296765,"07",2010-07-01
"Iowa","2010-08",2010,8,31000,12660,18340,84.0128263857077,"08",2010-08-01
"Iowa","2010-09",2010,9,30000,14104,15896,72.0841647016144,"09",2010-09-01
"Iowa","2011-01",2011,1,30000,11469,18531,89.3727844896188,"01",2011-01-01
"Iowa","2011-10",2011,10,42000,16987,25013,84.8085171308933,"10",2011-10-01
"Iowa","2011-11",2011,11,41000,13144,27856,102.89598108747,"11",2011-11-01
"Iowa","2011-12",2011,12,38000,13073,24927,97.6132202925225,"12",2011-12-01
"Iowa","2011-02",2011,2,32000,10663,21337,100.025783465767,"02",2011-02-01
"Iowa","2011-03",2011,3,35000,15186,19814,78.9622603913442,"03",2011-03-01
"Iowa","2011-04",2011,4,37000,15821,21179,80.1915904659132,"04",2011-04-01
"Iowa","2011-05",2011,5,37000,17872,19128,69.7186178743257,"05",2011-05-01
"Iowa","2011-06",2011,6,38000,17981,20019,71.5206945213555,"06",2011-06-01
"Iowa","2011-07",2011,7,41000,18144,22856,77.2893277424591,"07",2011-07-01
"Iowa","2011-08",2011,8,43000,14752,28248,97.8251835434271,"08",2011-08-01
"Iowa","2011-09",2011,9,42000,17603,24397,81.86500679496,"09",2011-09-01
"Iowa","2012-01",2012,1,36000,21333,14667,51.1642509549474,"01",2012-01-01
"Iowa","2012-10",2012,10,44000,11228,32772,118.678930977041,"10",2012-10-01
"Iowa","2012-11",2012,11,43000,10368,32632,122.290511167741,"11",2012-11-01
"Iowa","2012-12",2012,12,41000,14546,26454,95.2507831346992,"12",2012-12-01
"Iowa","2012-02",2012,2,36000,21478,14522,50.5306378092488,"02",2012-02-01
"Iowa","2012-03",2012,3,38000,24046,13954,44.9795313154756,"03",2012-03-01
"Iowa","2012-04",2012,4,39000,22203,16797,54.8894662026371,"04",2012-04-01
"Iowa","2012-05",2012,5,42000,21415,20585,64.9215485295277,"05",2012-05-01
"Iowa","2012-06",2012,6,45000,16792,28208,91.2998446400829,"06",2012-06-01
"Iowa","2012-07",2012,7,49000,12451,36549,118.953312395242,"07",2012-07-01
"Iowa","2012-08",2012,8,49000,7703,41297,145.660723418514,"08",2012-08-01
"Iowa","2012-09",2012,9,47000,9621,37379,132.032284841313,"09",2012-09-01
"Iowa","2013-01",2013,1,39000,20266,18734,63.2200587183208,"01",2013-01-01
"Iowa","2013-10",2013,10,51000,19692,31308,88.5757935834323,"10",2013-10-01
"Iowa","2013-11",2013,11,50000,17839,32161,94.815666504518,"11",2013-11-01
"Iowa","2013-12",2013,12,47000,18603,28397,86.5722604149201,"12",2013-12-01
"Iowa","2013-02",2013,2,39000,16537,22463,80.8938185353908,"02",2013-02-01
"Iowa","2013-03",2013,3,41000,18561,22439,75.3479625929719,"03",2013-03-01
"Iowa","2013-04",2013,4,46000,14904,31096,102.114803625378,"04",2013-04-01
"Iowa","2013-05",2013,5,47000,17898,29102,89.6853523991494,"05",2013-05-01
"Iowa","2013-06",2013,6,49000,24577,24423,66.3875939491961,"06",2013-06-01
"Iowa","2013-07",2013,7,46000,27118,18882,51.6480210071391,"07",2013-07-01
"Iowa","2013-08",2013,8,47000,18481,28519,87.1061834730685,"08",2013-08-01
"Iowa","2013-09",2013,9,48000,22358,25642,72.8900764660735,"09",2013-09-01
"Iowa","2014-01",2014,1,44000,21437,22563,68.9609853752464,"01",2014-01-01
"Iowa","2014-10",2014,10,51000,28045,22955,58.0808400278322,"10",2014-10-01
"Iowa","2014-11",2014,11,47000,18349,28651,87.6861160844083,"11",2014-11-01
"Iowa","2014-12",2014,12,46000,21412,24588,72.9484364801519,"12",2014-12-01
"Iowa","2014-02",2014,2,45000,25483,19517,55.3807301051317,"02",2014-02-01
"Iowa","2014-03",2014,3,47000,26080,20920,57.2523262178435,"03",2014-03-01
"Iowa","2014-04",2014,4,50000,26353,23647,61.9412465783925,"04",2014-04-01
"Iowa","2014-05",2014,5,49000,26289,22711,60.330194317895,"05",2014-05-01
"Iowa","2014-06",2014,6,49000,20932,28068,80.2722644855002,"06",2014-06-01
"Iowa","2014-07",2014,7,49000,15356,33644,104.555907763068,"07",2014-07-01
"Iowa","2014-08",2014,8,54000,21717,32283,85.2727921074528,"08",2014-08-01
"Iowa","2014-09",2014,9,52000,34304,17696,41.0085279940675,"09",2014-09-01
"Iowa","2015-01",2015,1,43000,20603,22397,70.4274955583856,"01",2015-01-01
"Iowa","2015-10",2015,10,57000,22064,34936,88.373975513508,"10",2015-10-01
"Iowa","2015-11",2015,11,56000,18825,37175,99.3651854326762,"11",2015-11-01
"Iowa","2015-12",2015,12,55000,18874,36126,97.8043696022958,"12",2015-12-01
"Iowa","2015-02",2015,2,45000,17912,27088,86.1139369277721,"02",2015-02-01
"Iowa","2015-03",2015,3,48000,20749,27251,79.2767894805743,"03",2015-03-01
"Iowa","2015-04",2015,4,55000,21963,33037,85.8516429972844,"04",2015-04-01
"Iowa","2015-05",2015,5,57000,23678,33322,82.6049232752423,"05",2015-05-01
"Iowa","2015-06",2015,6,57000,20831,36169,92.9424008428518,"06",2015-06-01
"Iowa","2015-07",2015,7,57000,25418,31582,76.638598364435,"07",2015-07-01
"Iowa","2015-08",2015,8,56000,24607,31393,77.8914982569752,"08",2015-08-01
"Iowa","2015-09",2015,9,58000,23384,34616,85.0683180969232,"09",2015-09-01
"Iowa","2016-01",2016,1,55000,23665,31335,79.6669420962309,"01",2016-01-01
"Iowa","2016-10",2016,10,56000,34173,21827,48.4113870005434,"10",2016-10-01
"Iowa","2016-11",2016,11,55000,28291,26709,64.1341801635231,"11",2016-11-01
"Iowa","2016-12",2016,12,55000,24177,30823,77.8584689998358,"12",2016-12-01
"Iowa","2016-02",2016,2,55000,23616,31384,79.8412536888165,"02",2016-02-01
"Iowa","2016-03",2016,3,60000,26129,33871,78.6517897572246,"03",2016-03-01
"Iowa","2016-04",2016,4,64000,27597,36403,79.4851359760691,"04",2016-04-01
"Iowa","2016-05",2016,5,64000,23043,40957,94.1075100812242,"05",2016-05-01
"Iowa","2016-06",2016,6,60000,28412,31588,71.4563633895851,"06",2016-06-01
"Iowa","2016-07",2016,7,62000,28514,33486,73.9907638597344,"07",2016-07-01
"Iowa","2016-08",2016,8,60000,30093,29907,66.3913955579235,"08",2016-08-01
"Iowa","2016-09",2016,9,61000,36019,24981,51.4971294282563,"09",2016-09-01
"Iowa","2017-01",2017,1,52000,27096,24904,62.9715788409022,"01",2017-01-01
"Iowa","2017-10",2017,10,72000,24106,47894,99.6691153517991,"10",2017-10-01
"Iowa","2017-11",2017,11,69000,21497,47503,104.982485607258,"11",2017-11-01
"Iowa","2017-12",2017,12,63000,18804,44196,108.05339592196,"12",2017-12-01
"Iowa","2017-02",2017,2,53000,27923,25077,61.9774353397674,"02",2017-02-01
"Iowa","2017-03",2017,3,54000,35562,18438,41.1737120653849,"03",2017-03-01
"Iowa","2017-04",2017,4,61000,28294,32706,73.2546419692252,"04",2017-04-01
"Iowa","2017-05",2017,5,62000,28784,33216,73.1758900246739,"05",2017-05-01
"Iowa","2017-06",2017,6,66000,25835,40165,87.4720966951598,"06",2017-06-01
"Iowa","2017-07",2017,7,65000,29213,35787,75.9704074809209,"07",2017-07-01
"Iowa","2017-08",2017,8,68000,27527,40473,84.7362525778052,"08",2017-08-01
"Iowa","2017-09",2017,9,71000,24603,46397,97.0618076838593,"09",2017-09-01
"Iowa","2018-01",2018,1,61000,25432,35568,82.3028507960015,"01",2018-01-01
"Iowa","2018-10",2018,10,86000,38455,47545,76.4051263508899,"10",2018-10-01
"Iowa","2018-11",2018,11,85000,23642,61358,112.954474328529,"11",2018-11-01
"Iowa","2018-12",2018,12,81000,25523,55477,104.159665048863,"12",2018-12-01
"Iowa","2018-02",2018,2,65000,26455,38545,84.2928216062544,"02",2018-02-01
"Iowa","2018-03",2018,3,72000,31984,40016,76.9656870287737,"03",2018-03-01
"Iowa","2018-04",2018,4,77000,35637,41363,73.4447827978373,"04",2018-04-01
"Iowa","2018-05",2018,5,84000,31268,52732,91.4946038796544,"05",2018-05-01
"Iowa","2018-06",2018,6,86000,22237,63763,117.821077819969,"06",2018-06-01
"Iowa","2018-07",2018,7,86000,27650,58350,102.683677958645,"07",2018-07-01
"Iowa","2018-08",2018,8,83000,28118,54882,98.781475548516,"08",2018-08-01
"Iowa","2018-09",2018,9,84000,23814,60186,111.647837943124,"09",2018-09-01
"Iowa","2019-01",2019,1,76000,23029,52971,106.980783406881,"01",2019-01-01
"Iowa","2019-10",2019,10,80000,21818,58182,114.286275511206,"10",2019-10-01
"Iowa","2019-11",2019,11,80000,27506,52494,97.6578051457593,"11",2019-11-01
"Iowa","2019-12",2019,12,74000,36253,37747,68.473420224393,"12",2019-12-01
"Iowa","2019-02",2019,2,76000,22347,53653,109.109581380215,"02",2019-02-01
"Iowa","2019-03",2019,3,77000,34043,42957,77.370027827058,"03",2019-03-01
"Iowa","2019-04",2019,4,81000,31863,49137,87.0737088328327,"04",2019-04-01
"Iowa","2019-05",2019,5,84000,34916,49084,82.5523899222981,"05",2019-05-01
"Iowa","2019-06",2019,6,86000,17124,68876,133.578992281137,"06",2019-06-01
"Iowa","2019-07",2019,7,84000,15408,68592,138.000965717045,"07",2019-07-01
"Iowa","2019-08",2019,8,79000,22713,56287,110.678084413988,"08",2019-08-01
"Iowa","2019-09",2019,9,77000,22601,54399,109.233843033704,"09",2019-09-01
"Kansas","2010-01",2010,1,25000,1526,23474,176.988614943829,"01",2010-01-01
"Kansas","2010-10",2010,10,29000,13449,15551,73.2690993898561,"10",2010-10-01
"Kansas","2010-11",2010,11,28000,11335,16665,84.7336977246727,"11",2010-11-01
"Kansas","2010-12",2010,12,27000,10818,16182,85.5782960495002,"12",2010-12-01
"Kansas","2010-02",2010,2,25000,5328,19672,129.728303877605,"02",2010-02-01
"Kansas","2010-03",2010,3,27000,9860,17140,93.0005425935974,"03",2010-03-01
"Kansas","2010-04",2010,4,27000,9213,17787,98.2354403114904,"04",2010-04-01
"Kansas","2010-05",2010,5,29000,10892,18108,90.7851198235235,"05",2010-05-01
"Kansas","2010-06",2010,6,29000,11469,17531,86.6391558971064,"06",2010-06-01
"Kansas","2010-07",2010,7,30000,11303,18697,90.535796431252,"07",2010-07-01
"Kansas","2010-08",2010,8,30000,12016,17984,85.6054836252856,"08",2010-08-01
"Kansas","2010-09",2010,9,30000,11526,18474,88.9755815633579,"09",2010-09-01
"Kansas","2011-01",2011,1,26000,9765,16235,90.7870823430728,"01",2011-01-01
"Kansas","2011-10",2011,10,34000,19533,14467,54.0489044140997,"10",2011-10-01
"Kansas","2011-11",2011,11,33000,10282,22718,104.976664664295,"11",2011-11-01
"Kansas","2011-12",2011,12,32000,27171,4829,16.322184854067,"12",2011-12-01
"Kansas","2011-02",2011,2,27000,9474,17526,96.101332455996,"02",2011-02-01
"Kansas","2011-03",2011,3,30000,12935,17065,79.492255735414,"03",2011-03-01
"Kansas","2011-04",2011,4,33000,10519,22481,103.315793101864,"04",2011-04-01
"Kansas","2011-05",2011,5,34000,13493,20507,86.3579895984671,"05",2011-05-01
"Kansas","2011-06",2011,6,35000,12722,22278,93.3657432630653,"06",2011-06-01
"Kansas","2011-07",2011,7,38000,13052,24948,97.7356420904176,"07",2011-07-01
"Kansas","2011-08",2011,8,38000,11803,26197,105.202497841495,"08",2011-08-01
"Kansas","2011-09",2011,9,37000,14253,22747,88.7635845706593,"09",2011-09-01
"Kansas","2012-01",2012,1,32000,13005,18995,84.4128430174425,"01",2012-01-01
"Kansas","2012-10",2012,10,36000,10945,25055,106.741932048141,"10",2012-10-01
"Kansas","2012-11",2012,11,35000,9769,25231,112.71638857245,"11",2012-11-01
"Kansas","2012-12",2012,12,34000,10886,23114,102.989796373034,"12",2012-12-01
"Kansas","2012-02",2012,2,33000,13689,19311,82.7218402621603,"02",2012-02-01
"Kansas","2012-03",2012,3,37000,13175,23825,94.9676133532636,"03",2012-03-01
"Kansas","2012-04",2012,4,37000,13009,23991,95.946729588674,"04",2012-04-01
"Kansas","2012-05",2012,5,36000,12497,23503,96.9255830257542,"05",2012-05-01
"Kansas","2012-06",2012,6,33000,11464,21536,96.8693774739115,"06",2012-06-01
"Kansas","2012-07",2012,7,36000,9120,26880,119.148936170213,"07",2012-07-01
"Kansas","2012-08",2012,8,37000,10720,26280,110.142497904443,"08",2012-08-01
"Kansas","2012-09",2012,9,37000,9760,27240,116.509837467921,"09",2012-09-01
"Kansas","2013-01",2013,1,32000,15915,16085,67.1397265991861,"01",2013-01-01
"Kansas","2013-10",2013,10,42000,19791,22209,71.8842549885906,"10",2013-10-01
"Kansas","2013-11",2013,11,39000,15371,23629,86.9176583104964,"11",2013-11-01
"Kansas","2013-12",2013,12,35000,14313,20687,83.9007969500943,"12",2013-12-01
"Kansas","2013-02",2013,2,32000,10625,21375,100.293255131965,"02",2013-02-01
"Kansas","2013-03",2013,3,32000,12554,19446,87.2918256497733,"03",2013-03-01
"Kansas","2013-04",2013,4,35000,9565,25435,114.147873892068,"04",2013-04-01
"Kansas","2013-05",2013,5,34000,14545,19455,80.1524358842311,"05",2013-05-01
"Kansas","2013-06",2013,6,36000,16371,19629,74.9613335624678,"06",2013-06-01
"Kansas","2013-07",2013,7,35000,20335,14665,53.0044275774826,"07",2013-07-01
"Kansas","2013-08",2013,8,39000,20660,18340,61.4817298022125,"08",2013-08-01
"Kansas","2013-09",2013,9,40000,25837,14163,43.0244391451615,"09",2013-09-01
"Kansas","2014-01",2014,1,34000,17994,16006,61.5686425356772,"01",2014-01-01
"Kansas","2014-10",2014,10,45000,20430,24570,75.1031636863824,"10",2014-10-01
"Kansas","2014-11",2014,11,41000,12063,28937,109.066581233628,"11",2014-11-01
"Kansas","2014-12",2014,12,40000,12234,27766,106.313895164069,"12",2014-12-01
"Kansas","2014-02",2014,2,35000,15602,19398,76.6689063673373,"02",2014-02-01
"Kansas","2014-03",2014,3,39000,18588,20412,70.8897687018129,"03",2014-03-01
"Kansas","2014-04",2014,4,40000,21650,18350,59.529602595296,"04",2014-04-01
"Kansas","2014-05",2014,5,44000,19880,24120,75.5165936130244,"05",2014-05-01
"Kansas","2014-06",2014,6,46000,18844,27156,83.7579421380544,"06",2014-06-01
"Kansas","2014-07",2014,7,48000,15126,32874,104.153597566771,"07",2014-07-01
"Kansas","2014-08",2014,8,49000,17900,31100,92.9745889387145,"08",2014-08-01
"Kansas","2014-09",2014,9,48000,19829,28171,83.0647658081352,"09",2014-09-01
"Kansas","2015-01",2015,1,41000,12744,28256,105.150342363799,"01",2015-01-01
"Kansas","2015-10",2015,10,51000,16853,34147,100.649934417049,"10",2015-10-01
"Kansas","2015-11",2015,11,50000,12640,37360,119.284802043423,"11",2015-11-01
"Kansas","2015-12",2015,12,48000,13730,34270,111.031913170258,"12",2015-12-01
"Kansas","2015-02",2015,2,45000,10309,34691,125.444321900595,"02",2015-02-01
"Kansas","2015-03",2015,3,48000,12627,35373,116.690583403434,"03",2015-03-01
"Kansas","2015-04",2015,4,49000,14483,34517,108.744073216452,"04",2015-04-01
"Kansas","2015-05",2015,5,47000,16825,30175,94.5554249902076,"05",2015-05-01
"Kansas","2015-06",2015,6,46000,15938,30062,97.0712648132003,"06",2015-06-01
"Kansas","2015-07",2015,7,49000,17974,31026,92.6508794457551,"07",2015-07-01
"Kansas","2015-08",2015,8,50000,17704,32296,95.4035212099728,"08",2015-08-01
"Kansas","2015-09",2015,9,52000,15450,36550,108.376575240919,"09",2015-09-01
"Kansas","2016-01",2016,1,49000,16962,32038,97.1407780237106,"01",2016-01-01
"Kansas","2016-10",2016,10,54000,26538,27462,68.1963793488788,"10",2016-10-01
"Kansas","2016-11",2016,11,54000,20482,33518,90.002953733788,"11",2016-11-01
"Kansas","2016-12",2016,12,53000,16763,36237,103.88601407623,"12",2016-12-01
"Kansas","2016-02",2016,2,51000,16213,34787,103.512713314389,"02",2016-02-01
"Kansas","2016-03",2016,3,54000,19918,34082,92.2156984766904,"03",2016-03-01
"Kansas","2016-04",2016,4,55000,18963,36037,97.446020307451,"04",2016-04-01
"Kansas","2016-05",2016,5,55000,19102,35898,96.888073196405,"05",2016-05-01
"Kansas","2016-06",2016,6,54000,20977,33023,88.0883470931086,"06",2016-06-01
"Kansas","2016-07",2016,7,57000,23217,33783,84.2290287594899,"07",2016-07-01
"Kansas","2016-08",2016,8,57000,20844,36156,92.8934792662248,"08",2016-08-01
"Kansas","2016-09",2016,9,57000,27928,29072,68.4626978146194,"09",2016-09-01
"Kansas","2017-01",2017,1,56000,18070,37930,102.41663291481,"01",2017-01-01
"Kansas","2017-10",2017,10,68000,13830,54170,132.396431626543,"10",2017-10-01
"Kansas","2017-11",2017,11,67000,12648,54352,136.480514262756,"11",2017-11-01
"Kansas","2017-12",2017,12,64000,9833,54167,146.728427667845,"12",2017-12-01
"Kansas","2017-02",2017,2,56000,18796,37204,99.481255682122,"02",2017-02-01
"Kansas","2017-03",2017,3,57000,25059,31941,77.8488648411509,"03",2017-03-01
"Kansas","2017-04",2017,4,54000,19493,34507,93.9055420244105,"04",2017-04-01
"Kansas","2017-05",2017,5,53000,19093,33907,94.0646109885842,"05",2017-05-01
"Kansas","2017-06",2017,6,54000,19339,34661,94.522695973493,"06",2017-06-01
"Kansas","2017-07",2017,7,57000,19343,37657,98.652135755734,"07",2017-07-01
"Kansas","2017-08",2017,8,61000,16903,44097,113.210017585972,"08",2017-08-01
"Kansas","2017-09",2017,9,65000,15027,49973,124.890349507041,"09",2017-09-01
"Kansas","2018-01",2018,1,67000,15081,51919,126.506743338897,"01",2018-01-01
"Kansas","2018-10",2018,10,88000,21804,66196,120.571199592,"10",2018-10-01
"Kansas","2018-11",2018,11,89000,21983,67017,120.769847634322,"11",2018-11-01
"Kansas","2018-12",2018,12,85000,20959,64041,120.878830491039,"12",2018-12-01
"Kansas","2018-02",2018,2,70000,17691,52309,119.303007150107,"02",2018-02-01
"Kansas","2018-03",2018,3,74000,19290,54710,117.290170436274,"03",2018-03-01
"Kansas","2018-04",2018,4,74000,20148,53852,114.39860644942,"04",2018-04-01
"Kansas","2018-05",2018,5,79000,24639,54361,104.904524358591,"05",2018-05-01
"Kansas","2018-06",2018,6,82000,20950,61050,118.601262748907,"06",2018-06-01
"Kansas","2018-07",2018,7,83000,26794,56206,102.384465453486,"07",2018-07-01
"Kansas","2018-08",2018,8,82000,24316,57684,108.51424056586,"08",2018-08-01
"Kansas","2018-09",2018,9,85000,19973,65027,123.892810532232,"09",2018-09-01
"Kansas","2019-01",2019,1,85000,19806,65194,124.408907886953,"01",2019-01-01
"Kansas","2019-10",2019,10,77000,35042,41958,74.8969136573785,"10",2019-10-01
"Kansas","2019-11",2019,11,73000,25118,47882,97.6008479585805,"11",2019-11-01
"Kansas","2019-12",2019,12,65000,32647,32353,66.2652206416992,"12",2019-12-01
"Kansas","2019-02",2019,2,83000,19578,63422,123.656144592408,"02",2019-02-01
"Kansas","2019-03",2019,3,83000,26993,56007,101.837389652069,"03",2019-03-01
"Kansas","2019-04",2019,4,80000,22936,57064,110.872775316702,"04",2019-04-01
"Kansas","2019-05",2019,5,77000,27910,49090,93.5849775998475,"05",2019-05-01
"Kansas","2019-06",2019,6,76000,20922,55078,113.654278698335,"06",2019-06-01
"Kansas","2019-07",2019,7,75000,20525,54475,114.053912588328,"07",2019-07-01
"Kansas","2019-08",2019,8,76000,22594,53406,108.335192810922,"08",2019-08-01
"Kansas","2019-09",2019,9,78000,28166,49834,93.879396416932,"09",2019-09-01
"Kentucky","2010-01",2010,1,34000,2464,31536,172.970601140851,"01",2010-01-01
"Kentucky","2010-10",2010,10,50000,11263,38737,126.461322494817,"10",2010-10-01
"Kentucky","2010-11",2010,11,50000,9717,40283,134.913006346601,"11",2010-11-01
"Kentucky","2010-12",2010,12,51000,12599,38401,120.759760373591,"12",2010-12-01
"Kentucky","2010-02",2010,2,35000,5080,29920,149.301397205589,"02",2010-02-01
"Kentucky","2010-03",2010,3,37000,7405,29595,133.29580002252,"03",2010-03-01
"Kentucky","2010-04",2010,4,41000,7294,33706,139.586698140556,"04",2010-04-01
"Kentucky","2010-05",2010,5,44000,11518,32482,117.014301667928,"05",2010-05-01
"Kentucky","2010-06",2010,6,46000,9203,36797,133.315218375813,"06",2010-06-01
"Kentucky","2010-07",2010,7,46000,11830,34170,118.173958153208,"07",2010-07-01
"Kentucky","2010-08",2010,8,48000,11521,36479,122.575225550646,"08",2010-08-01
"Kentucky","2010-09",2010,9,48000,10482,37518,128.306145480661,"09",2010-09-01
"Kentucky","2011-01",2011,1,46000,8536,37464,137.391814581194,"01",2011-01-01
"Kentucky","2011-10",2011,10,58000,10339,47661,139.484042786696,"10",2011-10-01
"Kentucky","2011-11",2011,11,58000,8815,49185,147.227418992741,"11",2011-11-01
"Kentucky","2011-12",2011,12,57000,9671,47329,141.977771444856,"12",2011-12-01
"Kentucky","2011-02",2011,2,45000,8937,36063,133.722676455865,"02",2011-02-01
"Kentucky","2011-03",2011,3,49000,11837,37163,122.172362213784,"03",2011-03-01
"Kentucky","2011-04",2011,4,52000,9981,42019,135.586712056921,"04",2011-04-01
"Kentucky","2011-05",2011,5,54000,12865,41135,123.038959096687,"05",2011-05-01
"Kentucky","2011-06",2011,6,49000,11122,37878,126.003792289012,"06",2011-06-01
"Kentucky","2011-07",2011,7,50000,12021,37979,122.471420970317,"07",2011-07-01
"Kentucky","2011-08",2011,8,50000,15448,34552,105.586114166972,"08",2011-08-01
"Kentucky","2011-09",2011,9,56000,9983,46017,139.48138156798,"09",2011-09-01
"Kentucky","2012-01",2012,1,55000,13713,41287,120.17231091642,"01",2012-01-01
"Kentucky","2012-10",2012,10,53000,10397,42603,134.400681420256,"10",2012-10-01
"Kentucky","2012-11",2012,11,54000,8828,45172,143.795759852295,"11",2012-11-01
"Kentucky","2012-12",2012,12,54000,10475,43525,135.013571151609,"12",2012-12-01
"Kentucky","2012-02",2012,2,52000,15287,36713,109.123604856807,"02",2012-02-01
"Kentucky","2012-03",2012,3,52000,15848,36152,106.567621742719,"03",2012-03-01
"Kentucky","2012-04",2012,4,54000,14435,39565,115.627968144955,"04",2012-04-01
"Kentucky","2012-05",2012,5,59000,11013,47987,137.080256523788,"05",2012-05-01
"Kentucky","2012-06",2012,6,60000,9839,50161,143.64753218116,"06",2012-06-01
"Kentucky","2012-07",2012,7,58000,18142,39858,104.69386146936,"07",2012-07-01
"Kentucky","2012-08",2012,8,56000,8244,47756,148.670692983002,"08",2012-08-01
"Kentucky","2012-09",2012,9,54000,20151,33849,91.2974875591698,"09",2012-09-01
"Kentucky","2013-01",2013,1,51000,15029,35971,108.955156067788,"01",2013-01-01
"Kentucky","2013-10",2013,10,52000,18004,33996,97.1258785212274,"10",2013-10-01
"Kentucky","2013-11",2013,11,51000,18452,32548,93.7280423889881,"11",2013-11-01
"Kentucky","2013-12",2013,12,51000,18936,32064,91.6952642415923,"12",2013-12-01
"Kentucky","2013-02",2013,2,49000,11945,37055,121.60144392485,"02",2013-02-01
"Kentucky","2013-03",2013,3,50000,13579,36421,114.569276018811,"03",2013-03-01
"Kentucky","2013-04",2013,4,55000,9525,45475,140.953118946145,"04",2013-04-01
"Kentucky","2013-05",2013,5,58000,12797,45203,127.697501306553,"05",2013-05-01
"Kentucky","2013-06",2013,6,59000,18909,40091,102.917506321478,"06",2013-06-01
"Kentucky","2013-07",2013,7,54000,20565,33435,89.6801448400724,"07",2013-07-01
"Kentucky","2013-08",2013,8,52000,23759,28241,74.5548383690387,"08",2013-08-01
"Kentucky","2013-09",2013,9,50000,18307,31693,92.7957603173906,"09",2013-09-01
"Kentucky","2014-01",2014,1,47000,22089,24911,72.1127820637149,"01",2014-01-01
"Kentucky","2014-10",2014,10,87000,22784,64216,116.986081760548,"10",2014-10-01
"Kentucky","2014-11",2014,11,80000,15113,64887,136.441916457267,"11",2014-11-01
"Kentucky","2014-12",2014,12,77000,15187,61813,134.103507002072,"12",2014-12-01
"Kentucky","2014-02",2014,2,49000,23693,25307,69.627061752851,"02",2014-02-01
"Kentucky","2014-03",2014,3,53000,20632,32368,87.9182963928727,"03",2014-03-01
"Kentucky","2014-04",2014,4,62000,22987,39013,91.8093355454364,"04",2014-04-01
"Kentucky","2014-05",2014,5,67000,23871,43129,94.9235729770774,"05",2014-05-01
"Kentucky","2014-06",2014,6,70000,19991,50009,111.142225333644,"06",2014-06-01
"Kentucky","2014-07",2014,7,75000,15809,59191,130.363730467244,"07",2014-07-01
"Kentucky","2014-08",2014,8,82000,22691,59309,113.302958229456,"08",2014-08-01
"Kentucky","2014-09",2014,9,86000,25177,60823,109.416516006008,"09",2014-09-01
"Kentucky","2015-01",2015,1,70000,14802,55198,130.180891960095,"01",2015-01-01
"Kentucky","2015-10",2015,10,93000,20266,72734,128.430420426253,"10",2015-10-01
"Kentucky","2015-11",2015,11,96000,15767,80233,143.571895103206,"11",2015-11-01
"Kentucky","2015-12",2015,12,95000,19496,75504,131.889323644494,"12",2015-12-01
"Kentucky","2015-02",2015,2,68000,10749,57251,145.401211443955,"02",2015-02-01
"Kentucky","2015-03",2015,3,68000,15275,52725,126.628640048034,"03",2015-03-01
"Kentucky","2015-04",2015,4,77000,18118,58882,123.808322294413,"04",2015-04-01
"Kentucky","2015-05",2015,5,79000,22876,56124,110.181004358239,"05",2015-05-01
"Kentucky","2015-06",2015,6,80000,19867,60133,120.426166801846,"06",2015-06-01
"Kentucky","2015-07",2015,7,79000,21138,57862,115.564520961074,"07",2015-07-01
"Kentucky","2015-08",2015,8,85000,22635,62365,115.882380266642,"08",2015-08-01
"Kentucky","2015-09",2015,9,90000,20206,69794,126.660980345898,"09",2015-09-01
"Kentucky","2016-01",2016,1,92000,21997,70003,122.81551268893,"01",2016-01-01
"Kentucky","2016-10",2016,10,75000,39096,35904,62.9364745477493,"10",2016-10-01
"Kentucky","2016-11",2016,11,74000,23561,50439,103.399924150019,"11",2016-11-01
"Kentucky","2016-12",2016,12,73000,20351,52649,112.79793467665,"12",2016-12-01
"Kentucky","2016-02",2016,2,88000,21343,66657,121.922756829427,"02",2016-02-01
"Kentucky","2016-03",2016,3,96000,22576,73424,123.842936175955,"03",2016-03-01
"Kentucky","2016-04",2016,4,1e+05,30145,69855,107.349494794268,"04",2016-04-01
"Kentucky","2016-05",2016,5,98000,24475,73525,120.06531945295,"05",2016-05-01
"Kentucky","2016-06",2016,6,87000,33520,53480,88.7487553932957,"06",2016-06-01
"Kentucky","2016-07",2016,7,87000,33625,53375,88.4974093264249,"07",2016-07-01
"Kentucky","2016-08",2016,8,85000,35645,49355,81.8185585809607,"08",2016-08-01
"Kentucky","2016-09",2016,9,84000,38480,45520,74.3305029392554,"09",2016-09-01
"Kentucky","2017-01",2017,1,72000,23551,48449,101.409718370294,"01",2017-01-01
"Kentucky","2017-10",2017,10,84000,19066,64934,126.004696020026,"10",2017-10-01
"Kentucky","2017-11",2017,11,80000,17118,62882,129.496076937334,"11",2017-11-01
"Kentucky","2017-12",2017,12,79000,15608,63392,134.009808895654,"12",2017-12-01
"Kentucky","2017-02",2017,2,72000,24409,47591,98.7272972440332,"02",2017-02-01
"Kentucky","2017-03",2017,3,72000,32164,39836,76.4870780691986,"03",2017-03-01
"Kentucky","2017-04",2017,4,79000,22841,56159,110.28760518848,"04",2017-04-01
"Kentucky","2017-05",2017,5,79000,23776,55224,107.464777769129,"05",2017-05-01
"Kentucky","2017-06",2017,6,80000,26330,53670,100.949873036772,"06",2017-06-01
"Kentucky","2017-07",2017,7,82000,26204,55796,103.13112269417,"07",2017-07-01
"Kentucky","2017-08",2017,8,91000,26428,64572,109.977177504513,"08",2017-08-01
"Kentucky","2017-09",2017,9,91000,20258,70742,127.167484585378,"09",2017-09-01
"Kentucky","2018-01",2018,1,84000,18407,65593,128.102571113303,"01",2018-01-01
"Kentucky","2018-10",2018,10,98000,32749,65251,99.8110884213264,"10",2018-10-01
"Kentucky","2018-11",2018,11,98000,29945,68055,106.381648364532,"11",2018-11-01
"Kentucky","2018-12",2018,12,96000,26300,69700,113.982011447261,"12",2018-12-01
"Kentucky","2018-02",2018,2,82000,21658,60342,116.425167377337,"02",2018-02-01
"Kentucky","2018-03",2018,3,84000,26426,57574,104.276166844765,"03",2018-03-01
"Kentucky","2018-04",2018,4,84000,24268,59732,110.34100565264,"04",2018-04-01
"Kentucky","2018-05",2018,5,87000,36141,50859,82.6028698808683,"05",2018-05-01
"Kentucky","2018-06",2018,6,89000,25889,63111,109.864303806283,"06",2018-06-01
"Kentucky","2018-07",2018,7,89000,32689,56311,92.5490389435364,"07",2018-07-01
"Kentucky","2018-08",2018,8,93000,30728,62272,100.659511185827,"08",2018-08-01
"Kentucky","2018-09",2018,9,96000,28441,67559,108.579969624159,"09",2018-09-01
"Kentucky","2019-01",2019,1,98000,24620,73380,119.686837383787,"01",2019-01-01
"Kentucky","2019-10",2019,10,94000,48163,45837,64.4851332625226,"10",2019-10-01
"Kentucky","2019-11",2019,11,91000,38288,52712,81.5419837881319,"11",2019-11-01
"Kentucky","2019-12",2019,12,86000,46199,39801,60.2137686366765,"12",2019-12-01
"Kentucky","2019-02",2019,2,96000,23357,72643,121.723903918497,"02",2019-02-01
"Kentucky","2019-03",2019,3,96000,31565,64435,101.023007878337,"03",2019-03-01
"Kentucky","2019-04",2019,4,92000,27834,64166,107.091476542551,"04",2019-04-01
"Kentucky","2019-05",2019,5,89000,37036,51964,82.4589799739757,"05",2019-05-01
"Kentucky","2019-06",2019,6,86000,28527,57473,100.365852593712,"06",2019-06-01
"Kentucky","2019-07",2019,7,82000,25713,56287,104.512918589214,"07",2019-07-01
"Kentucky","2019-08",2019,8,86000,31931,54069,91.6959917239742,"08",2019-08-01
"Kentucky","2019-09",2019,9,88000,46334,41666,62.0334390400048,"09",2019-09-01
"Louisiana","2010-01",2010,1,35000,3912,31088,159.786184210526,"01",2010-01-01
"Louisiana","2010-10",2010,10,44000,13041,30959,108.549990357813,"10",2010-10-01
"Louisiana","2010-11",2010,11,44000,12597,31403,110.970546142022,"11",2010-11-01
"Louisiana","2010-12",2010,12,44000,12157,31843,113.407055220186,"12",2010-12-01
"Louisiana","2010-02",2010,2,37000,7103,29897,135.578078588758,"02",2010-02-01
"Louisiana","2010-03",2010,3,38000,9798,28202,118.004937445081,"03",2010-03-01
"Louisiana","2010-04",2010,4,38000,8432,29568,127.360441075121,"04",2010-04-01
"Louisiana","2010-05",2010,5,39000,11999,27001,105.888350751976,"05",2010-05-01
"Louisiana","2010-06",2010,6,37000,8292,28708,126.768524242692,"06",2010-06-01
"Louisiana","2010-07",2010,7,40000,12831,27169,102.85249190816,"07",2010-07-01
"Louisiana","2010-08",2010,8,40000,10521,29479,116.699986144376,"08",2010-08-01
"Louisiana","2010-09",2010,9,42000,11944,30056,111.434079786445,"09",2010-09-01
"Louisiana","2011-01",2011,1,41000,9524,31476,124.598210751326,"01",2011-01-01
"Louisiana","2011-10",2011,10,55000,12362,42638,126.593628455212,"10",2011-10-01
"Louisiana","2011-11",2011,11,53000,9741,43259,137.897068902313,"11",2011-11-01
"Louisiana","2011-12",2011,12,50000,12180,37820,121.646831778707,"12",2011-12-01
"Louisiana","2011-02",2011,2,43000,12039,30961,112.505677792111,"02",2011-02-01
"Louisiana","2011-03",2011,3,46000,17079,28921,91.6977123923968,"03",2011-03-01
"Louisiana","2011-04",2011,4,48000,11124,36876,124.741221838847,"04",2011-04-01
"Louisiana","2011-05",2011,5,50000,18344,31656,92.6372468687815,"05",2011-05-01
"Louisiana","2011-06",2011,6,48000,13999,34001,109.682414232488,"06",2011-06-01
"Louisiana","2011-07",2011,7,48000,11968,36032,120.17075773746,"07",2011-07-01
"Louisiana","2011-08",2011,8,49000,12649,36351,117.928920177132,"08",2011-08-01
"Louisiana","2011-09",2011,9,55000,11841,43159,129.139300728595,"09",2011-09-01
"Louisiana","2012-01",2012,1,52000,14439,37561,113.069131082647,"01",2012-01-01
"Louisiana","2012-10",2012,10,54000,11141,42859,131.588400546507,"10",2012-10-01
"Louisiana","2012-11",2012,11,51000,8910,42090,140.510766149224,"11",2012-11-01
"Louisiana","2012-12",2012,12,52000,11392,40608,128.117112569409,"12",2012-12-01
"Louisiana","2012-02",2012,2,54000,16120,37880,108.043354249857,"02",2012-02-01
"Louisiana","2012-03",2012,3,55000,14039,40961,118.660467272122,"03",2012-03-01
"Louisiana","2012-04",2012,4,53000,12663,40337,122.860667346908,"04",2012-04-01
"Louisiana","2012-05",2012,5,54000,13201,40799,121.423788336483,"05",2012-05-01
"Louisiana","2012-06",2012,6,57000,11978,45022,130.540172228827,"06",2012-06-01
"Louisiana","2012-07",2012,7,55000,11062,43938,133.020495897793,"07",2012-07-01
"Louisiana","2012-08",2012,8,54000,9699,44301,139.094805255969,"08",2012-08-01
"Louisiana","2012-09",2012,9,51000,10278,40722,132.909037501224,"09",2012-09-01
"Louisiana","2013-01",2013,1,52000,15394,36606,108.632815977683,"01",2013-01-01
"Louisiana","2013-10",2013,10,61000,27274,33726,76.4120805673245,"10",2013-10-01
"Louisiana","2013-11",2013,11,57000,18731,38269,101.065613817327,"11",2013-11-01
"Louisiana","2013-12",2013,12,54000,17356,36644,102.707550871686,"12",2013-12-01
"Louisiana","2013-02",2013,2,55000,12893,42107,124.039297129306,"02",2013-02-01
"Louisiana","2013-03",2013,3,57000,15700,41300,113.617606602476,"03",2013-03-01
"Louisiana","2013-04",2013,4,55000,11092,43908,132.869333656116,"04",2013-04-01
"Louisiana","2013-05",2013,5,57000,14661,42339,118.164692091933,"05",2013-05-01
"Louisiana","2013-06",2013,6,56000,21761,34239,88.0621391185813,"06",2013-06-01
"Louisiana","2013-07",2013,7,54000,23506,30494,78.6881015663303,"07",2013-07-01
"Louisiana","2013-08",2013,8,55000,25363,29637,73.757823874171,"08",2013-08-01
"Louisiana","2013-09",2013,9,56000,29607,26393,61.660845491607,"09",2013-09-01
"Louisiana","2014-01",2014,1,51000,24434,26566,70.4350823236206,"01",2014-01-01
"Louisiana","2014-10",2014,10,77000,24669,52331,102.943866862072,"10",2014-10-01
"Louisiana","2014-11",2014,11,72000,16176,55824,126.619488296135,"11",2014-11-01
"Louisiana","2014-12",2014,12,68000,15534,52466,125.615916872172,"12",2014-12-01
"Louisiana","2014-02",2014,2,54000,21718,32282,85.2690245384189,"02",2014-02-01
"Louisiana","2014-03",2014,3,58000,22135,35865,89.5114494290884,"03",2014-03-01
"Louisiana","2014-04",2014,4,61000,23329,37671,89.3429306644215,"04",2014-04-01
"Louisiana","2014-05",2014,5,61000,24736,36264,84.5945693757581,"05",2014-05-01
"Louisiana","2014-06",2014,6,64000,18308,45692,111.026874665889,"06",2014-06-01
"Louisiana","2014-07",2014,7,67000,16240,50760,121.960595867371,"07",2014-07-01
"Louisiana","2014-08",2014,8,73000,22997,50003,104.176172172047,"08",2014-08-01
"Louisiana","2014-09",2014,9,75000,23022,51978,106.053743037277,"09",2014-09-01
"Louisiana","2015-01",2015,1,69000,13896,55104,132.9473074696,"01",2015-01-01
"Louisiana","2015-10",2015,10,83000,20921,62079,119.47344617546,"10",2015-10-01
"Louisiana","2015-11",2015,11,79000,15988,63012,132.6736008759,"11",2015-11-01
"Louisiana","2015-12",2015,12,82000,17315,64685,130.262296732618,"12",2015-12-01
"Louisiana","2015-02",2015,2,73000,10869,62131,148.162014570342,"02",2015-02-01
"Louisiana","2015-03",2015,3,76000,19413,56587,118.614863802626,"03",2015-03-01
"Louisiana","2015-04",2015,4,84000,18529,65471,127.712159486584,"04",2015-04-01
"Louisiana","2015-05",2015,5,88000,20611,67389,124.092403163584,"05",2015-05-01
"Louisiana","2015-06",2015,6,91000,19186,71814,130.350498248416,"06",2015-06-01
"Louisiana","2015-07",2015,7,86000,24779,61221,110.528168696233,"07",2015-07-01
"Louisiana","2015-08",2015,8,86000,20399,65601,123.311309316817,"08",2015-08-01
"Louisiana","2015-09",2015,9,83000,19281,63719,124.595966015193,"09",2015-09-01
"Louisiana","2016-01",2016,1,80000,23184,56816,110.125600868352,"01",2016-01-01
"Louisiana","2016-10",2016,10,73000,21316,51684,109.597523219814,"10",2016-10-01
"Louisiana","2016-11",2016,11,71000,17933,53067,119.341526767342,"11",2016-11-01
"Louisiana","2016-12",2016,12,68000,16183,51817,123.105615147951,"12",2016-12-01
"Louisiana","2016-02",2016,2,83000,18255,64745,127.88504271394,"02",2016-02-01
"Louisiana","2016-03",2016,3,88000,22205,65795,119.404745701193,"03",2016-03-01
"Louisiana","2016-04",2016,4,85000,22029,62971,117.670911622084,"04",2016-04-01
"Louisiana","2016-05",2016,5,84000,18631,65369,127.386462180043,"05",2016-05-01
"Louisiana","2016-06",2016,6,77000,17951,59049,124.377836989605,"06",2016-06-01
"Louisiana","2016-07",2016,7,76000,19050,56950,119.831667543398,"07",2016-07-01
"Louisiana","2016-08",2016,8,73000,17066,55934,124.206692869673,"08",2016-08-01
"Louisiana","2016-09",2016,9,76000,21044,54956,113.259964552162,"09",2016-09-01
"Louisiana","2017-01",2017,1,72000,18856,53144,116.985119309677,"01",2017-01-01
"Louisiana","2017-10",2017,10,70000,15853,54147,126.138865269705,"10",2017-10-01
"Louisiana","2017-11",2017,11,71000,14953,56047,130.413132758601,"11",2017-11-01
"Louisiana","2017-12",2017,12,69000,11586,57414,142.491251582161,"12",2017-12-01
"Louisiana","2017-02",2017,2,76000,18326,57674,122.286538176113,"02",2017-02-01
"Louisiana","2017-03",2017,3,80000,23474,56526,109.25643156735,"03",2017-03-01
"Louisiana","2017-04",2017,4,81000,19367,61633,122.815267966563,"04",2017-04-01
"Louisiana","2017-05",2017,5,77000,18073,58927,123.961587411778,"05",2017-05-01
"Louisiana","2017-06",2017,6,74000,18724,55276,119.226953108149,"06",2017-06-01
"Louisiana","2017-07",2017,7,73000,17741,55259,121.794998953064,"07",2017-07-01
"Louisiana","2017-08",2017,8,73000,17108,55892,124.055577751143,"08",2017-08-01
"Louisiana","2017-09",2017,9,74000,15418,58582,131.029546623722,"09",2017-09-01
"Louisiana","2018-01",2018,1,73000,17075,55925,124.174299195115,"01",2018-01-01
"Louisiana","2018-10",2018,10,87000,22325,64675,118.316944889092,"10",2018-10-01
"Louisiana","2018-11",2018,11,84000,23140,60860,113.608362889677,"11",2018-11-01
"Louisiana","2018-12",2018,12,84000,21652,62348,118.025214856321,"12",2018-12-01
"Louisiana","2018-02",2018,2,73000,18276,54724,119.908847889916,"02",2018-02-01
"Louisiana","2018-03",2018,3,80000,22730,57270,111.496154969337,"03",2018-03-01
"Louisiana","2018-04",2018,4,84000,26872,57128,103.052168266109,"04",2018-04-01
"Louisiana","2018-05",2018,5,86000,31012,54988,93.9869415102724,"05",2018-05-01
"Louisiana","2018-06",2018,6,86000,22237,63763,117.821077819969,"06",2018-06-01
"Louisiana","2018-07",2018,7,89000,27630,61370,105.238789333791,"07",2018-07-01
"Louisiana","2018-08",2018,8,92000,25980,66020,111.917274114257,"08",2018-08-01
"Louisiana","2018-09",2018,9,90000,23247,66753,117.88921560836,"09",2018-09-01
"Louisiana","2019-01",2019,1,85000,20391,64609,122.60819235039,"01",2019-01-01
"Louisiana","2019-10",2019,10,99000,35341,63659,94.7722586552132,"10",2019-10-01
"Louisiana","2019-11",2019,11,93000,29952,63048,102.557095451884,"11",2019-11-01
"Louisiana","2019-12",2019,12,85000,31085,53915,92.8888314597062,"12",2019-12-01
"Louisiana","2019-02",2019,2,87000,19773,67227,125.925093422494,"02",2019-02-01
"Louisiana","2019-03",2019,3,94000,29448,64552,104.581686216059,"03",2019-03-01
"Louisiana","2019-04",2019,4,94000,24270,69730,117.916631436543,"04",2019-04-01
"Louisiana","2019-05",2019,5,95000,28441,66559,107.839372655763,"05",2019-05-01
"Louisiana","2019-06",2019,6,90000,23761,66239,116.452914443438,"06",2019-06-01
"Louisiana","2019-07",2019,7,90000,20304,69696,126.370757180157,"07",2019-07-01
"Louisiana","2019-08",2019,8,94000,24595,69405,117.04540663603,"08",2019-08-01
"Louisiana","2019-09",2019,9,95000,42132,52868,77.105270833941,"09",2019-09-01
"Maine","2010-01",2010,1,14000,1162,12838,169.344413665743,"01",2010-01-01
"Maine","2010-10",2010,10,17000,6198,10802,93.1287179929304,"10",2010-10-01
"Maine","2010-11",2010,11,17000,4951,12049,109.780875586534,"11",2010-11-01
"Maine","2010-12",2010,12,16000,6128,9872,89.2263195950832,"12",2010-12-01
"Maine","2010-02",2010,2,14000,6215,7785,77.0220133564185,"02",2010-02-01
"Maine","2010-03",2010,3,14000,4946,9054,95.5769027763116,"03",2010-03-01
"Maine","2010-04",2010,4,17000,4037,12963,123.240005704235,"04",2010-04-01
"Maine","2010-05",2010,5,19000,6350,12650,99.8027613412229,"05",2010-05-01
"Maine","2010-06",2010,6,21000,4198,16802,133.35979045956,"06",2010-06-01
"Maine","2010-07",2010,7,19000,6306,12694,100.32403382597,"07",2010-07-01
"Maine","2010-08",2010,8,19000,7056,11944,91.6794596254222,"08",2010-08-01
"Maine","2010-09",2010,9,18000,5615,12385,104.890959136142,"09",2010-09-01
"Maine","2011-01",2011,1,16000,3999,12001,120.01600080004,"01",2011-01-01
"Maine","2011-10",2011,10,19000,5026,13974,116.323982352452,"10",2011-10-01
"Maine","2011-11",2011,11,18000,3695,14305,131.873703618345,"11",2011-11-01
"Maine","2011-12",2011,12,17000,3719,13281,128.201168010039,"12",2011-12-01
"Maine","2011-02",2011,2,16000,4977,11023,105.096057586881,"02",2011-02-01
"Maine","2011-03",2011,3,17000,5665,11335,100.022060445621,"03",2011-03-01
"Maine","2011-04",2011,4,18000,4966,13034,113.506923277889,"04",2011-04-01
"Maine","2011-05",2011,5,19000,7516,11484,86.619399607784,"05",2011-05-01
"Maine","2011-06",2011,6,21000,7985,13015,89.8050715887528,"06",2011-06-01
"Maine","2011-07",2011,7,21000,6064,14936,110.375406443985,"07",2011-07-01
"Maine","2011-08",2011,8,21000,5666,15334,115.00787519688,"08",2011-08-01
"Maine","2011-09",2011,9,20000,5806,14194,110.005425094939,"09",2011-09-01
"Maine","2012-01",2012,1,17000,4696,12304,113.421828908555,"01",2012-01-01
"Maine","2012-10",2012,10,20000,5438,14562,114.490132872081,"10",2012-10-01
"Maine","2012-11",2012,11,17000,4656,12344,114.000738825268,"11",2012-11-01
"Maine","2012-12",2012,12,16000,4855,11145,106.880843922321,"12",2012-12-01
"Maine","2012-02",2012,2,17000,5827,11173,97.8928461909143,"02",2012-02-01
"Maine","2012-03",2012,3,18000,6517,11483,93.6737773789615,"03",2012-03-01
"Maine","2012-04",2012,4,18000,5526,12474,106.044376434583,"04",2012-04-01
"Maine","2012-05",2012,5,19000,4711,14289,120.526337986588,"05",2012-05-01
"Maine","2012-06",2012,6,21000,4431,16569,130.305532617671,"06",2012-06-01
"Maine","2012-07",2012,7,20000,4039,15961,132.792545446982,"07",2012-07-01
"Maine","2012-08",2012,8,21000,4337,16663,131.530962623831,"08",2012-08-01
"Maine","2012-09",2012,9,19000,4333,14667,125.718938841983,"09",2012-09-01
"Maine","2013-01",2013,1,17000,8394,8606,67.7797905016933,"01",2013-01-01
"Maine","2013-10",2013,10,19000,18707,293,1.55408810035272,"10",2013-10-01
"Maine","2013-11",2013,11,19000,10502,8498,57.6096535828079,"11",2013-11-01
"Maine","2013-12",2013,12,20000,9021,10979,75.6624513283484,"12",2013-12-01
"Maine","2013-02",2013,2,17000,6100,10900,94.3722943722944,"02",2013-02-01
"Maine","2013-03",2013,3,17000,5535,11465,101.752828932771,"03",2013-03-01
"Maine","2013-04",2013,4,17000,3846,13154,126.201669385014,"04",2013-04-01
"Maine","2013-05",2013,5,19000,4648,14352,121.380243572395,"05",2013-05-01
"Maine","2013-06",2013,6,22000,7174,14826,101.638445190923,"06",2013-06-01
"Maine","2013-07",2013,7,22000,14336,7664,42.184059885513,"07",2013-07-01
"Maine","2013-08",2013,8,22000,22180,-180,-0.814848347668628,"08",2013-08-01
"Maine","2013-09",2013,9,20000,23138,-3138,-14.5486577959108,"09",2013-09-01
"Maine","2014-01",2014,1,19000,7506,11494,86.7275333886667,"01",2014-01-01
"Maine","2014-10",2014,10,21000,9455,11545,75.8167788540469,"10",2014-10-01
"Maine","2014-11",2014,11,20000,6359,13641,103.501650290223,"11",2014-11-01
"Maine","2014-12",2014,12,22000,5809,16191,116.444316588155,"12",2014-12-01
"Maine","2014-02",2014,2,18000,9968,8032,57.4370709382151,"02",2014-02-01
"Maine","2014-03",2014,3,16000,15477,523,3.32306128284144,"03",2014-03-01
"Maine","2014-04",2014,4,18000,12229,5771,38.1818783287572,"04",2014-04-01
"Maine","2014-05",2014,5,21000,7706,13294,92.6217515501986,"05",2014-05-01
"Maine","2014-06",2014,6,24000,7392,16608,105.810397553517,"06",2014-06-01
"Maine","2014-07",2014,7,26000,5157,20843,133.793369066341,"07",2014-07-01
"Maine","2014-08",2014,8,25000,7012,17988,112.382856428839,"08",2014-08-01
"Maine","2014-09",2014,9,22000,8838,13162,85.3622154484727,"09",2014-09-01
"Maine","2015-01",2015,1,20000,5653,14347,111.854364012006,"01",2015-01-01
"Maine","2015-10",2015,10,24000,8909,15091,91.7135130207542,"10",2015-10-01
"Maine","2015-11",2015,11,23000,7115,15885,105.495600199236,"11",2015-11-01
"Maine","2015-12",2015,12,24000,6497,17503,114.785060825655,"12",2015-12-01
"Maine","2015-02",2015,2,21000,4262,16738,132.515240281846,"02",2015-02-01
"Maine","2015-03",2015,3,20000,5465,14535,114.156685646966,"03",2015-03-01
"Maine","2015-04",2015,4,23000,7259,15741,104.041772695727,"04",2015-04-01
"Maine","2015-05",2015,5,25000,7632,17368,106.447658739887,"05",2015-05-01
"Maine","2015-06",2015,6,27000,9343,17657,97.1686432050188,"06",2015-06-01
"Maine","2015-07",2015,7,29000,10053,18947,97.03223824034,"07",2015-07-01
"Maine","2015-08",2015,8,27000,9636,17364,94.7920078611202,"08",2015-08-01
"Maine","2015-09",2015,9,26000,9284,16716,94.7511619997733,"09",2015-09-01
"Maine","2016-01",2016,1,25000,9294,15706,91.5961975855835,"01",2016-01-01
"Maine","2016-10",2016,10,26000,8386,17614,102.448670970744,"10",2016-10-01
"Maine","2016-11",2016,11,25000,6536,18464,117.097919837646,"11",2016-11-01
"Maine","2016-12",2016,12,26000,7208,18792,113.177547578897,"12",2016-12-01
"Maine","2016-02",2016,2,25000,8331,16669,100.021001470103,"02",2016-02-01
"Maine","2016-03",2016,3,25000,10932,14068,78.3034620950685,"03",2016-03-01
"Maine","2016-04",2016,4,29000,7713,21287,115.964372293193,"04",2016-04-01
"Maine","2016-05",2016,5,32000,6445,25555,132.943165561191,"05",2016-05-01
"Maine","2016-06",2016,6,34000,7562,26438,127.221981617824,"06",2016-06-01
"Maine","2016-07",2016,7,31000,7350,23650,123.337679269883,"07",2016-07-01
"Maine","2016-08",2016,8,30000,7194,22806,122.632682690757,"08",2016-08-01
"Maine","2016-09",2016,9,28000,8724,19276,104.977671277639,"09",2016-09-01
"Maine","2017-01",2017,1,25000,6949,18051,112.998841904285,"01",2017-01-01
"Maine","2017-10",2017,10,26000,6679,19321,118.247192386548,"10",2017-10-01
"Maine","2017-11",2017,11,25000,6962,18038,112.87153494775,"11",2017-11-01
"Maine","2017-12",2017,12,27000,6302,20698,124.304846555762,"12",2017-12-01
"Maine","2017-02",2017,2,25000,8166,16834,101.513598263282,"02",2017-02-01
"Maine","2017-03",2017,3,25000,10088,14912,84.9977200182398,"03",2017-03-01
"Maine","2017-04",2017,4,28000,8038,19962,110.783062323103,"04",2017-04-01
"Maine","2017-05",2017,5,30000,7825,22175,117.2504957039,"05",2017-05-01
"Maine","2017-06",2017,6,32000,7834,24166,121.333534166792,"06",2017-06-01
"Maine","2017-07",2017,7,32000,8167,23833,118.669554609505,"07",2017-07-01
"Maine","2017-08",2017,8,31000,7295,23705,123.802062932498,"08",2017-08-01
"Maine","2017-09",2017,9,29000,6622,22378,125.641457526248,"09",2017-09-01
"Maine","2018-01",2018,1,30000,7493,22507,120.059744485637,"01",2018-01-01
"Maine","2018-10",2018,10,32000,6439,25561,132.995135149197,"10",2018-10-01
"Maine","2018-11",2018,11,31000,5529,25471,139.456322374004,"11",2018-11-01
"Maine","2018-12",2018,12,31000,7834,23166,119.307823041665,"12",2018-12-01
"Maine","2018-02",2018,2,30000,7912,22088,116.52247309559,"02",2018-02-01
"Maine","2018-03",2018,3,30000,11130,18870,91.7578409919767,"03",2018-03-01
"Maine","2018-04",2018,4,33000,8391,24609,118.909907951004,"04",2018-04-01
"Maine","2018-05",2018,5,37000,8234,28766,127.18751381704,"05",2018-05-01
"Maine","2018-06",2018,6,39000,7187,31813,137.757377617078,"06",2018-06-01
"Maine","2018-07",2018,7,37000,6760,30240,138.208409506399,"07",2018-07-01
"Maine","2018-08",2018,8,35000,7273,27727,131.180659049512,"08",2018-08-01
"Maine","2018-09",2018,9,33000,6968,26032,130.264211369095,"09",2018-09-01
"Maine","2019-01",2019,1,33000,6020,26980,138.288057406458,"01",2019-01-01
"Maine","2019-10",2019,10,33000,7342,25658,127.202419314858,"10",2019-10-01
"Maine","2019-11",2019,11,30000,7686,22314,118.420633657061,"11",2019-11-01
"Maine","2019-12",2019,12,28000,5846,22154,130.910595048159,"12",2019-12-01
"Maine","2019-02",2019,2,32000,5239,26761,143.725663954456,"02",2019-02-01
"Maine","2019-03",2019,3,33000,7379,25621,126.902597885039,"03",2019-03-01
"Maine","2019-04",2019,4,33000,6953,26047,130.388206142217,"04",2019-04-01
"Maine","2019-05",2019,5,36000,7520,28480,130.882352941176,"05",2019-05-01
"Maine","2019-06",2019,6,38000,6942,31058,138.213697654755,"06",2019-06-01
"Maine","2019-07",2019,7,36000,5046,30954,150.825902645812,"07",2019-07-01
"Maine","2019-08",2019,8,35000,6596,28404,136.570824117704,"08",2019-08-01
"Maine","2019-09",2019,9,34000,13605,20395,85.6842768616742,"09",2019-09-01
"Maryland","2010-01",2010,1,65000,5594,59406,168.303255234156,"01",2010-01-01
"Maryland","2010-10",2010,10,70000,31574,38426,75.6610943745447,"10",2010-10-01
"Maryland","2010-11",2010,11,69000,26100,42900,90.2208201892744,"11",2010-11-01
"Maryland","2010-12",2010,12,63000,28012,34988,76.8865644090889,"12",2010-12-01
"Maryland","2010-02",2010,2,63000,17791,45209,111.915931229964,"02",2010-02-01
"Maryland","2010-03",2010,3,65000,16639,48361,118.475238550203,"03",2010-03-01
"Maryland","2010-04",2010,4,61000,22978,38022,90.5522875038701,"04",2010-04-01
"Maryland","2010-05",2010,5,69000,24752,44248,94.3937196006485,"05",2010-05-01
"Maryland","2010-06",2010,6,70000,20576,49424,109.132662073839,"06",2010-06-01
"Maryland","2010-07",2010,7,65000,29613,35387,74.8036739137328,"07",2010-07-01
"Maryland","2010-08",2010,8,65000,28488,36512,78.1105596440185,"08",2010-08-01
"Maryland","2010-09",2010,9,72000,24235,47765,99.2674182989557,"09",2010-09-01
"Maryland","2011-01",2011,1,60000,26885,33115,76.2271968694251,"01",2011-01-01
"Maryland","2011-10",2011,10,76000,32563,43437,80.0217385297017,"10",2011-10-01
"Maryland","2011-11",2011,11,76000,20456,55544,115.169611014349,"11",2011-11-01
"Maryland","2011-12",2011,12,76000,21933,54067,110.416305024864,"12",2011-12-01
"Maryland","2011-02",2011,2,60000,21299,38701,95.2065831068033,"02",2011-02-01
"Maryland","2011-03",2011,3,61000,29843,31157,68.5952687603888,"03",2011-03-01
"Maryland","2011-04",2011,4,65000,22477,42523,97.2209838014564,"04",2011-04-01
"Maryland","2011-05",2011,5,73000,28727,44273,87.0427713389759,"05",2011-05-01
"Maryland","2011-06",2011,6,78000,29013,48987,91.5533626755628,"06",2011-06-01
"Maryland","2011-07",2011,7,84000,31287,52713,91.4465637929688,"07",2011-07-01
"Maryland","2011-08",2011,8,82000,29744,52256,93.5280641466208,"08",2011-08-01
"Maryland","2011-09",2011,9,83000,33287,49713,85.5005288639315,"09",2011-09-01
"Maryland","2012-01",2012,1,83000,24251,58749,109.554223270646,"01",2012-01-01
"Maryland","2012-10",2012,10,77000,24632,52368,103.054156171285,"10",2012-10-01
"Maryland","2012-11",2012,11,80000,20293,59707,119.065139142313,"11",2012-11-01
"Maryland","2012-12",2012,12,75000,24835,50165,100.495818099865,"12",2012-12-01
"Maryland","2012-02",2012,2,80000,27656,52344,97.2430705209185,"02",2012-02-01
"Maryland","2012-03",2012,3,81000,27372,53628,98.970213708338,"03",2012-03-01
"Maryland","2012-04",2012,4,78000,25589,52411,101.190280821323,"04",2012-04-01
"Maryland","2012-05",2012,5,81000,27265,53735,99.2656906664204,"05",2012-05-01
"Maryland","2012-06",2012,6,78000,25131,52869,102.527852924921,"06",2012-06-01
"Maryland","2012-07",2012,7,76000,23953,52047,104.142947185177,"07",2012-07-01
"Maryland","2012-08",2012,8,73000,23071,49929,103.941876320638,"08",2012-08-01
"Maryland","2012-09",2012,9,75000,22037,52963,109.160423343673,"09",2012-09-01
"Maryland","2013-01",2013,1,78000,34045,43955,78.4595475032353,"01",2013-01-01
"Maryland","2013-10",2013,10,74000,34556,39444,72.6703268359188,"10",2013-10-01
"Maryland","2013-11",2013,11,73000,32205,40795,77.5533482248943,"11",2013-11-01
"Maryland","2013-12",2013,12,73000,30084,42916,83.2641341042257,"12",2013-12-01
"Maryland","2013-02",2013,2,76000,27200,48800,94.5736434108527,"02",2013-02-01
"Maryland","2013-03",2013,3,80000,26976,53024,99.1325157044571,"03",2013-03-01
"Maryland","2013-04",2013,4,80000,23934,56066,107.887697962168,"04",2013-04-01
"Maryland","2013-05",2013,5,87000,23876,63124,113.864136512861,"05",2013-05-01
"Maryland","2013-06",2013,6,86000,39419,46581,74.2806113906186,"06",2013-06-01
"Maryland","2013-07",2013,7,81000,39469,41531,68.9488582124862,"07",2013-07-01
"Maryland","2013-08",2013,8,75000,36912,38088,68.067767531632,"08",2013-08-01
"Maryland","2013-09",2013,9,74000,31191,42809,81.3928948294056,"09",2013-09-01
"Maryland","2014-01",2014,1,71000,35974,35026,65.4850711387814,"01",2014-01-01
"Maryland","2014-10",2014,10,1e+05,40195,59805,85.3168800599165,"10",2014-10-01
"Maryland","2014-11",2014,11,88000,28645,59355,101.770328775344,"11",2014-11-01
"Maryland","2014-12",2014,12,94000,26267,67733,112.637714418752,"12",2014-12-01
"Maryland","2014-02",2014,2,71000,30056,40944,81.0322989233692,"02",2014-02-01
"Maryland","2014-03",2014,3,77000,36110,40890,72.3012996198391,"03",2014-03-01
"Maryland","2014-04",2014,4,85000,34407,50593,84.7404256031891,"04",2014-04-01
"Maryland","2014-05",2014,5,93000,35242,57758,90.0765739773241,"05",2014-05-01
"Maryland","2014-06",2014,6,1e+05,28891,71109,110.33974443522,"06",2014-06-01
"Maryland","2014-07",2014,7,104000,25512,78488,121.205756995491,"07",2014-07-01
"Maryland","2014-08",2014,8,112000,30177,81823,115.10019201418,"08",2014-08-01
"Maryland","2014-09",2014,9,104000,33782,70218,101.926231292912,"09",2014-09-01
"Maryland","2015-01",2015,1,99000,26391,72609,115.812139627246,"01",2015-01-01
"Maryland","2015-10",2015,10,111000,40656,70344,92.767843013135,"10",2015-10-01
"Maryland","2015-11",2015,11,115000,31387,83613,114.235553703539,"11",2015-11-01
"Maryland","2015-12",2015,12,113000,31270,81730,113.301448672628,"12",2015-12-01
"Maryland","2015-02",2015,2,106000,23681,82319,126.956146235763,"02",2015-02-01
"Maryland","2015-03",2015,3,106000,26672,79328,119.585142305837,"03",2015-03-01
"Maryland","2015-04",2015,4,110000,29744,80256,114.861460957179,"04",2015-04-01
"Maryland","2015-05",2015,5,115000,34399,80601,107.900320617943,"05",2015-05-01
"Maryland","2015-06",2015,6,120000,41257,78743,97.6614968652524,"06",2015-06-01
"Maryland","2015-07",2015,7,121000,46451,74549,89.0397788009627,"07",2015-07-01
"Maryland","2015-08",2015,8,116000,44250,71750,89.5475819032761,"08",2015-08-01
"Maryland","2015-09",2015,9,114000,43121,70879,90.2221854494307,"09",2015-09-01
"Maryland","2016-01",2016,1,112000,40199,71801,94.3514740569912,"01",2016-01-01
"Maryland","2016-10",2016,10,112000,43550,68450,88.0102860816458,"10",2016-10-01
"Maryland","2016-11",2016,11,110000,36510,73490,100.320797215207,"11",2016-11-01
"Maryland","2016-12",2016,12,108000,35603,72397,100.829369859961,"12",2016-12-01
"Maryland","2016-02",2016,2,112000,37294,74706,100.079038675365,"02",2016-02-01
"Maryland","2016-03",2016,3,117000,39024,77976,99.9538532533456,"03",2016-03-01
"Maryland","2016-04",2016,4,118000,37954,80046,102.653346499609,"04",2016-04-01
"Maryland","2016-05",2016,5,113000,33661,79339,108.193725666673,"05",2016-05-01
"Maryland","2016-06",2016,6,109000,40286,68714,92.0568573074501,"06",2016-06-01
"Maryland","2016-07",2016,7,110000,42676,67324,88.1919882627263,"07",2016-07-01
"Maryland","2016-08",2016,8,114000,40008,73992,96.0885148823438,"08",2016-08-01
"Maryland","2016-09",2016,9,115000,47089,67911,83.7947053779097,"09",2016-09-01
"Maryland","2017-01",2017,1,102000,38105,63895,91.2101638057171,"01",2017-01-01
"Maryland","2017-10",2017,10,110000,35294,74706,102.834253307088,"10",2017-10-01
"Maryland","2017-11",2017,11,108000,32430,75570,107.626575518052,"11",2017-11-01
"Maryland","2017-12",2017,12,110000,26497,83503,122.35140699063,"12",2017-12-01
"Maryland","2017-02",2017,2,101000,42443,58557,81.6449739617827,"02",2017-02-01
"Maryland","2017-03",2017,3,104000,49327,54673,71.315554338114,"03",2017-03-01
"Maryland","2017-04",2017,4,115000,38813,76187,99.0644483886278,"04",2017-04-01
"Maryland","2017-05",2017,5,119000,38053,80947,103.082398935391,"05",2017-05-01
"Maryland","2017-06",2017,6,126000,41990,84010,100.017858205846,"06",2017-06-01
"Maryland","2017-07",2017,7,130000,43109,86891,100.388772391961,"07",2017-07-01
"Maryland","2017-08",2017,8,128000,38506,89494,107.496426555199,"08",2017-08-01
"Maryland","2017-09",2017,9,121000,34906,86094,110.443472348723,"09",2017-09-01
"Maryland","2018-01",2018,1,119000,33771,85229,111.57745907273,"01",2018-01-01
"Maryland","2018-10",2018,10,145000,56148,88852,88.3449002724362,"10",2018-10-01
"Maryland","2018-11",2018,11,146000,51560,94440,95.6063980562867,"11",2018-11-01
"Maryland","2018-12",2018,12,143000,46254,96746,102.239318587718,"12",2018-12-01
"Maryland","2018-02",2018,2,119000,38377,80623,102.458427851592,"02",2018-02-01
"Maryland","2018-03",2018,3,118000,52743,65257,76.4388584012229,"03",2018-03-01
"Maryland","2018-04",2018,4,117000,39635,77365,98.7837967248699,"04",2018-04-01
"Maryland","2018-05",2018,5,125000,64706,60294,63.5657280212539,"05",2018-05-01
"Maryland","2018-06",2018,6,134000,44757,89243,99.848397545271,"06",2018-06-01
"Maryland","2018-07",2018,7,145000,61901,83099,80.327306296248,"07",2018-07-01
"Maryland","2018-08",2018,8,147000,54308,92692,92.0897331452302,"08",2018-08-01
"Maryland","2018-09",2018,9,149000,48577,100423,101.654544810378,"09",2018-09-01
"Maryland","2019-01",2019,1,140000,48741,91259,96.702889144383,"01",2019-01-01
"Maryland","2019-10",2019,10,138000,61723,76277,76.3827901643777,"10",2019-10-01
"Maryland","2019-11",2019,11,139000,59220,79780,80.4964181212794,"11",2019-11-01
"Maryland","2019-12",2019,12,139000,53765,85235,88.4341037013981,"12",2019-12-01
"Maryland","2019-02",2019,2,137000,47926,89074,96.3347501162627,"02",2019-02-01
"Maryland","2019-03",2019,3,141000,55809,85191,86.5722604149201,"03",2019-03-01
"Maryland","2019-04",2019,4,139000,46790,92210,99.2626083212229,"04",2019-04-01
"Maryland","2019-05",2019,5,137000,57501,79499,81.7466234106766,"05",2019-05-01
"Maryland","2019-06",2019,6,132000,41708,90292,103.958366914592,"06",2019-06-01
"Maryland","2019-07",2019,7,135000,41080,93920,106.678782371649,"07",2019-07-01
"Maryland","2019-08",2019,8,134000,63004,70996,72.0756938945402,"08",2019-08-01
"Maryland","2019-09",2019,9,134000,76268,57732,54.9127779785797,"09",2019-09-01
"Massachusetts","2010-01",2010,1,72000,5653,66347,170.880712915148,"01",2010-01-01
"Massachusetts","2010-10",2010,10,102000,35488,66512,96.753171185849,"10",2010-10-01
"Massachusetts","2010-11",2010,11,96000,31189,64811,101.912901272909,"11",2010-11-01
"Massachusetts","2010-12",2010,12,88000,36071,51929,83.7085217335235,"12",2010-12-01
"Massachusetts","2010-02",2010,2,72000,21114,50886,109.29827952832,"02",2010-02-01
"Massachusetts","2010-03",2010,3,75000,24745,50255,100.76695573713,"03",2010-03-01
"Massachusetts","2010-04",2010,4,80000,34833,45167,78.6655403934409,"04",2010-04-01
"Massachusetts","2010-05",2010,5,89000,33749,55251,90.0227293094037,"05",2010-05-01
"Massachusetts","2010-06",2010,6,93000,26398,66602,111.563007755574,"06",2010-06-01
"Massachusetts","2010-07",2010,7,94000,41730,52270,77.0205555146246,"07",2010-07-01
"Massachusetts","2010-08",2010,8,96000,34410,61590,94.4559466298597,"08",2010-08-01
"Massachusetts","2010-09",2010,9,98000,35714,62286,93.1630195791017,"09",2010-09-01
"Massachusetts","2011-01",2011,1,76000,31125,44875,83.7806301050175,"01",2011-01-01
"Massachusetts","2011-10",2011,10,83000,30532,52468,92.4285663953775,"10",2011-10-01
"Massachusetts","2011-11",2011,11,78000,21033,56967,115.046499651631,"11",2011-11-01
"Massachusetts","2011-12",2011,12,75000,24986,50014,100.042005880823,"12",2011-12-01
"Massachusetts","2011-02",2011,2,75000,28309,46691,90.3909630332304,"02",2011-02-01
"Massachusetts","2011-03",2011,3,81000,40801,40199,66.0076682457451,"03",2011-03-01
"Massachusetts","2011-04",2011,4,83000,29040,53960,96.3227418779008,"04",2011-04-01
"Massachusetts","2011-05",2011,5,83000,34782,48218,81.8766874395069,"05",2011-05-01
"Massachusetts","2011-06",2011,6,82000,33981,48019,82.8049421888068,"06",2011-06-01
"Massachusetts","2011-07",2011,7,84000,39244,44756,72.6299049040927,"07",2011-07-01
"Massachusetts","2011-08",2011,8,86000,43294,42706,66.0602966881681,"08",2011-08-01
"Massachusetts","2011-09",2011,9,86000,37469,48531,78.6124452291668,"09",2011-09-01
"Massachusetts","2012-01",2012,1,75000,34105,40895,74.9644837541818,"01",2012-01-01
"Massachusetts","2012-10",2012,10,93000,29146,63854,104.553567042719,"10",2012-10-01
"Massachusetts","2012-11",2012,11,88000,27884,60116,103.752027889959,"11",2012-11-01
"Massachusetts","2012-12",2012,12,87000,31748,55252,93.0575672853438,"12",2012-12-01
"Massachusetts","2012-02",2012,2,80000,33711,46289,81.4151665186306,"02",2012-02-01
"Massachusetts","2012-03",2012,3,86000,38674,47326,75.9195983123987,"03",2012-03-01
"Massachusetts","2012-04",2012,4,85000,32009,52991,90.5759386030134,"04",2012-04-01
"Massachusetts","2012-05",2012,5,87000,36114,50886,82.6648472147765,"05",2012-05-01
"Massachusetts","2012-06",2012,6,86000,32106,53894,91.2637799942425,"06",2012-06-01
"Massachusetts","2012-07",2012,7,87000,27367,59633,104.283578304931,"07",2012-07-01
"Massachusetts","2012-08",2012,8,92000,25183,66817,114.038725753736,"08",2012-08-01
"Massachusetts","2012-09",2012,9,90000,26131,63869,109.994747311226,"09",2012-09-01
"Massachusetts","2013-01",2013,1,87000,47370,39630,58.9863808885912,"01",2013-01-01
"Massachusetts","2013-10",2013,10,112000,53094,58906,71.3605582274341,"10",2013-10-01
"Massachusetts","2013-11",2013,11,106000,46437,59563,78.1476938013737,"11",2013-11-01
"Massachusetts","2013-12",2013,12,1e+05,44982,55018,75.8963181636341,"12",2013-12-01
"Massachusetts","2013-02",2013,2,86000,38848,47152,75.5350506215558,"02",2013-02-01
"Massachusetts","2013-03",2013,3,96000,36404,59596,90.0214495030362,"03",2013-03-01
"Massachusetts","2013-04",2013,4,96000,31440,64560,101.318267419962,"04",2013-04-01
"Massachusetts","2013-05",2013,5,99000,37400,61600,90.3225806451613,"05",2013-05-01
"Massachusetts","2013-06",2013,6,99000,57031,41969,53.7957200812659,"06",2013-06-01
"Massachusetts","2013-07",2013,7,98000,63316,34684,43.0013141907808,"07",2013-07-01
"Massachusetts","2013-08",2013,8,105000,52263,52737,67.0685412334751,"08",2013-08-01
"Massachusetts","2013-09",2013,9,107000,54343,52657,65.2733617200622,"09",2013-09-01
"Massachusetts","2014-01",2014,1,95000,53105,41895,56.5747273893522,"01",2014-01-01
"Massachusetts","2014-10",2014,10,144000,55507,88493,88.711674277093,"10",2014-10-01
"Massachusetts","2014-11",2014,11,132000,43578,88422,100.721047056009,"11",2014-11-01
"Massachusetts","2014-12",2014,12,133000,39437,93563,108.518473413479,"12",2014-12-01
"Massachusetts","2014-02",2014,2,97000,45303,51697,72.6576389816097,"02",2014-02-01
"Massachusetts","2014-03",2014,3,103000,53420,49580,63.39342795039,"03",2014-03-01
"Massachusetts","2014-04",2014,4,112000,49022,62978,78.222851535815,"04",2014-04-01
"Massachusetts","2014-05",2014,5,119000,56727,62273,70.8747090657668,"05",2014-05-01
"Massachusetts","2014-06",2014,6,126000,42408,83592,99.2731936725096,"06",2014-06-01
"Massachusetts","2014-07",2014,7,127000,37077,89923,109.610731546774,"07",2014-07-01
"Massachusetts","2014-08",2014,8,137000,47261,89739,97.4042255279196,"08",2014-08-01
"Massachusetts","2014-09",2014,9,135000,53586,81414,86.3415099742293,"09",2014-09-01
"Massachusetts","2015-01",2015,1,130000,39955,90045,105.963343237916,"01",2015-01-01
"Massachusetts","2015-10",2015,10,153000,52751,100249,97.4469139882674,"10",2015-10-01
"Massachusetts","2015-11",2015,11,153000,44743,108257,109.492624264829,"11",2015-11-01
"Massachusetts","2015-12",2015,12,153000,43126,109874,112.044298053292,"12",2015-12-01
"Massachusetts","2015-02",2015,2,134000,33641,100359,119.730853430843,"02",2015-02-01
"Massachusetts","2015-03",2015,3,138000,41643,96357,107.276097593561,"03",2015-03-01
"Massachusetts","2015-04",2015,4,151000,42154,108846,112.703852884227,"04",2015-04-01
"Massachusetts","2015-05",2015,5,156000,46593,109407,108.006693222372,"05",2015-05-01
"Massachusetts","2015-06",2015,6,150000,47594,102406,103.652944927478,"06",2015-06-01
"Massachusetts","2015-07",2015,7,140000,55754,84246,86.0733369433064,"07",2015-07-01
"Massachusetts","2015-08",2015,8,140000,61087,78913,78.4864262732051,"08",2015-08-01
"Massachusetts","2015-09",2015,9,148000,52325,95675,95.51978035692,"09",2015-09-01
"Massachusetts","2016-01",2016,1,145000,55513,89487,89.2580530938144,"01",2016-01-01
"Massachusetts","2016-10",2016,10,155000,60019,94981,88.3466112297053,"10",2016-10-01
"Massachusetts","2016-11",2016,11,149000,51402,97598,97.4022215347152,"11",2016-11-01
"Massachusetts","2016-12",2016,12,146000,49894,96106,98.1204120595832,"12",2016-12-01
"Massachusetts","2016-02",2016,2,137000,50449,86551,92.3461848289401,"02",2016-02-01
"Massachusetts","2016-03",2016,3,135000,59276,75724,77.9550742242995,"03",2016-03-01
"Massachusetts","2016-04",2016,4,135000,54384,80616,85.1349638829046,"04",2016-04-01
"Massachusetts","2016-05",2016,5,140000,50163,89837,94.4842056551485,"05",2016-05-01
"Massachusetts","2016-06",2016,6,139000,55143,83857,86.3868385674477,"06",2016-06-01
"Massachusetts","2016-07",2016,7,147000,54061,92939,92.4485603871462,"07",2016-07-01
"Massachusetts","2016-08",2016,8,151000,49188,101812,101.716386596599,"08",2016-08-01
"Massachusetts","2016-09",2016,9,158000,65260,92740,83.0780256203529,"09",2016-09-01
"Massachusetts","2017-01",2017,1,143000,52228,90772,92.9907595221997,"01",2017-01-01
"Massachusetts","2017-10",2017,10,156000,47940,108060,105.972344807296,"10",2017-10-01
"Massachusetts","2017-11",2017,11,148000,47982,100018,102.068557316488,"11",2017-11-01
"Massachusetts","2017-12",2017,12,142000,40199,101801,111.747045812546,"12",2017-12-01
"Massachusetts","2017-02",2017,2,155000,57509,97491,91.7523493122644,"02",2017-02-01
"Massachusetts","2017-03",2017,3,157000,64454,92546,83.5803372257896,"03",2017-03-01
"Massachusetts","2017-04",2017,4,160000,64638,95362,84.9028214282535,"04",2017-04-01
"Massachusetts","2017-05",2017,5,151000,65318,85682,79.2185578638856,"05",2017-05-01
"Massachusetts","2017-06",2017,6,147000,64570,82430,77.9222006900789,"06",2017-06-01
"Massachusetts","2017-07",2017,7,153000,70229,82771,74.1579275094186,"07",2017-07-01
"Massachusetts","2017-08",2017,8,159000,63289,95711,86.1140227361678,"08",2017-08-01
"Massachusetts","2017-09",2017,9,158000,57181,100819,93.7062287097839,"09",2017-09-01
"Massachusetts","2018-01",2018,1,133000,48832,84168,92.5777640899292,"01",2018-01-01
"Massachusetts","2018-10",2018,10,179000,83054,95946,73.2261289657857,"10",2018-10-01
"Massachusetts","2018-11",2018,11,190000,79122,110878,82.3998038064521,"11",2018-11-01
"Massachusetts","2018-12",2018,12,190000,75256,114744,86.5156678831016,"12",2018-12-01
"Massachusetts","2018-02",2018,2,133000,54981,78019,83.0073252083987,"02",2018-02-01
"Massachusetts","2018-03",2018,3,141000,65289,75711,73.4028474615709,"03",2018-03-01
"Massachusetts","2018-04",2018,4,149000,63959,85041,79.8660775078771,"04",2018-04-01
"Massachusetts","2018-05",2018,5,157000,100896,56104,43.509011384434,"05",2018-05-01
"Massachusetts","2018-06",2018,6,161000,69020,91980,79.9756542909312,"06",2018-06-01
"Massachusetts","2018-07",2018,7,164000,91319,72681,56.9334832111985,"07",2018-07-01
"Massachusetts","2018-08",2018,8,165000,81381,83619,67.8777990185932,"08",2018-08-01
"Massachusetts","2018-09",2018,9,173000,74428,98572,79.6773202709475,"09",2018-09-01
"Massachusetts","2019-01",2019,1,189000,76645,112355,84.5903367275876,"01",2019-01-01
"Massachusetts","2019-10",2019,10,182000,92195,89805,65.5044767410055,"10",2019-10-01
"Massachusetts","2019-11",2019,11,164000,90179,73821,58.0858371462631,"11",2019-11-01
"Massachusetts","2019-12",2019,12,149000,86554,62446,53.020538814879,"12",2019-12-01
"Massachusetts","2019-02",2019,2,179000,70485,108515,86.9912018758643,"02",2019-02-01
"Massachusetts","2019-03",2019,3,181000,81260,99740,76.061923282239,"03",2019-03-01
"Massachusetts","2019-04",2019,4,176000,73927,102073,81.6822512173555,"04",2019-04-01
"Massachusetts","2019-05",2019,5,179000,87887,91113,68.278335025685,"05",2019-05-01
"Massachusetts","2019-06",2019,6,175000,68352,106648,87.6491666392715,"06",2019-06-01
"Massachusetts","2019-07",2019,7,172000,67878,104122,86.812463002026,"07",2019-07-01
"Massachusetts","2019-08",2019,8,177000,97831,79169,57.6128602668549,"08",2019-08-01
"Massachusetts","2019-09",2019,9,177000,109653,67347,46.9885192201024,"09",2019-09-01
"Michigan","2010-01",2010,1,55000,4794,50206,167.929892631368,"01",2010-01-01
"Michigan","2010-10",2010,10,90000,30812,59188,97.9836440088733,"10",2010-10-01
"Michigan","2010-11",2010,11,87000,29631,57369,98.3769323764694,"11",2010-11-01
"Michigan","2010-12",2010,12,79000,34806,44194,77.6655009401965,"12",2010-12-01
"Michigan","2010-02",2010,2,56000,12735,43265,125.889284934895,"02",2010-02-01
"Michigan","2010-03",2010,3,62000,20732,41268,99.7630904607649,"03",2010-03-01
"Michigan","2010-04",2010,4,70000,23751,46249,98.6634809228702,"04",2010-04-01
"Michigan","2010-05",2010,5,74000,30060,43940,84.4512781087834,"05",2010-05-01
"Michigan","2010-06",2010,6,75000,18578,56422,120.588172433692,"06",2010-06-01
"Michigan","2010-07",2010,7,79000,31521,47479,85.9185132237312,"07",2010-07-01
"Michigan","2010-08",2010,8,82000,29894,52106,93.1345737930541,"08",2010-08-01
"Michigan","2010-09",2010,9,92000,35128,56872,89.4720281920584,"09",2010-09-01
"Michigan","2011-01",2011,1,80000,29839,50161,91.3355001411156,"01",2011-01-01
"Michigan","2011-10",2011,10,114000,28515,85485,119.966319334807,"10",2011-10-01
"Michigan","2011-11",2011,11,111000,20085,90915,138.711523057558,"11",2011-11-01
"Michigan","2011-12",2011,12,103000,21081,81919,132.041166657264,"12",2011-12-01
"Michigan","2011-02",2011,2,84000,32371,51629,88.7317286952935,"02",2011-02-01
"Michigan","2011-03",2011,3,93000,45745,47255,68.1177700097301,"03",2011-03-01
"Michigan","2011-04",2011,4,96000,32766,63234,98.2153674106519,"04",2011-04-01
"Michigan","2011-05",2011,5,98000,39720,58280,84.6354923032239,"05",2011-05-01
"Michigan","2011-06",2011,6,1e+05,29017,70983,110.036661835262,"06",2011-06-01
"Michigan","2011-07",2011,7,105000,43980,61020,81.9170358437374,"07",2011-07-01
"Michigan","2011-08",2011,8,108000,36536,71464,98.8874744008413,"08",2011-08-01
"Michigan","2011-09",2011,9,112000,43400,68600,88.2882882882883,"09",2011-09-01
"Michigan","2012-01",2012,1,101000,46785,54215,73.370098453835,"01",2012-01-01
"Michigan","2012-10",2012,10,115000,22561,92439,134.397103830301,"10",2012-10-01
"Michigan","2012-11",2012,11,117000,27088,89912,124.801510188218,"11",2012-11-01
"Michigan","2012-12",2012,12,116000,31148,84852,115.328784625003,"12",2012-12-01
"Michigan","2012-02",2012,2,105000,38761,66239,92.1515570982394,"02",2012-02-01
"Michigan","2012-03",2012,3,118000,49523,68477,81.7523563928535,"03",2012-03-01
"Michigan","2012-04",2012,4,122000,42743,79257,96.2189592274027,"04",2012-04-01
"Michigan","2012-05",2012,5,123000,46547,76453,90.1850224421547,"05",2012-05-01
"Michigan","2012-06",2012,6,119000,46191,72809,88.1512915352531,"06",2012-06-01
"Michigan","2012-07",2012,7,116000,41597,74403,94.4218481316269,"07",2012-07-01
"Michigan","2012-08",2012,8,116000,39110,76890,99.1425440010315,"08",2012-08-01
"Michigan","2012-09",2012,9,118000,32637,85363,113.336032979945,"09",2012-09-01
"Michigan","2013-01",2013,1,114000,37604,76396,100.783620484948,"01",2013-01-01
"Michigan","2013-10",2013,10,122000,57558,64442,71.778478263291,"10",2013-10-01
"Michigan","2013-11",2013,11,121000,54572,66428,75.6703802428633,"11",2013-11-01
"Michigan","2013-12",2013,12,117000,46995,70005,85.3745541022592,"12",2013-12-01
"Michigan","2013-02",2013,2,110000,40777,69223,91.8216969431677,"02",2013-02-01
"Michigan","2013-03",2013,3,107000,44050,62950,83.3498841443231,"03",2013-03-01
"Michigan","2013-04",2013,4,112000,33833,78167,107.200702173034,"04",2013-04-01
"Michigan","2013-05",2013,5,115000,36065,78935,104.504683414424,"05",2013-05-01
"Michigan","2013-06",2013,6,118000,49357,68643,82.0318241842289,"06",2013-06-01
"Michigan","2013-07",2013,7,119000,78459,40541,41.0627016241346,"07",2013-07-01
"Michigan","2013-08",2013,8,118000,62220,55780,61.9021196315614,"08",2013-08-01
"Michigan","2013-09",2013,9,118000,59995,58005,65.1759880895531,"09",2013-09-01
"Michigan","2014-01",2014,1,105000,59143,45857,55.874450936074,"01",2014-01-01
"Michigan","2014-10",2014,10,152000,56928,95072,91.0093429315362,"10",2014-10-01
"Michigan","2014-11",2014,11,148000,48672,99328,101.008786202408,"11",2014-11-01
"Michigan","2014-12",2014,12,138000,47079,90921,98.2510171332242,"12",2014-12-01
"Michigan","2014-02",2014,2,103000,57781,45219,56.2491836722001,"02",2014-02-01
"Michigan","2014-03",2014,3,104000,57168,46832,58.1157549885833,"03",2014-03-01
"Michigan","2014-04",2014,4,115000,57123,57877,67.250745106697,"04",2014-04-01
"Michigan","2014-05",2014,5,122000,57787,64213,71.4323060065522,"05",2014-05-01
"Michigan","2014-06",2014,6,125000,50557,74443,84.8077832271,"06",2014-06-01
"Michigan","2014-07",2014,7,128000,40786,87214,103.34269429929,"07",2014-07-01
"Michigan","2014-08",2014,8,134000,49462,84538,92.1585941502873,"08",2014-08-01
"Michigan","2014-09",2014,9,145000,54339,90661,90.9616281811387,"09",2014-09-01
"Michigan","2015-01",2015,1,139000,47951,91049,97.4041326336848,"01",2015-01-01
"Michigan","2015-10",2015,10,179000,65827,113173,92.4514044611093,"10",2015-10-01
"Michigan","2015-11",2015,11,174000,49097,124903,111.971922526973,"11",2015-11-01
"Michigan","2015-12",2015,12,160000,52787,107213,100.770253821897,"12",2015-12-01
"Michigan","2015-02",2015,2,147000,36282,110718,120.817101515697,"02",2015-02-01
"Michigan","2015-03",2015,3,151000,53181,97819,95.8159672055676,"03",2015-03-01
"Michigan","2015-04",2015,4,150000,49447,100553,100.831799926798,"04",2015-04-01
"Michigan","2015-05",2015,5,149000,58661,90339,87.0062264941419,"05",2015-05-01
"Michigan","2015-06",2015,6,155000,53111,101889,97.9179380234586,"06",2015-06-01
"Michigan","2015-07",2015,7,160000,64633,95367,84.9091629457827,"07",2015-07-01
"Michigan","2015-08",2015,8,167000,64413,102587,88.6613975878624,"08",2015-08-01
"Michigan","2015-09",2015,9,177000,64464,112536,93.2114103965808,"09",2015-09-01
"Michigan","2016-01",2016,1,147000,66645,80355,75.222916520396,"01",2016-01-01
"Michigan","2016-10",2016,10,184000,78186,105814,80.7167430755265,"10",2016-10-01
"Michigan","2016-11",2016,11,191000,65749,125251,97.5668843890336,"11",2016-11-01
"Michigan","2016-12",2016,12,188000,62788,125212,99.8548574891941,"12",2016-12-01
"Michigan","2016-02",2016,2,148000,49432,98568,99.8500749625187,"02",2016-02-01
"Michigan","2016-03",2016,3,155000,73791,81209,70.9896805381331,"03",2016-03-01
"Michigan","2016-04",2016,4,166000,63381,102619,89.4747167376548,"04",2016-04-01
"Michigan","2016-05",2016,5,169000,57341,111659,98.6644045930697,"05",2016-05-01
"Michigan","2016-06",2016,6,176000,60188,115812,98.0676410317205,"06",2016-06-01
"Michigan","2016-07",2016,7,182000,66359,115641,93.1240663716636,"07",2016-07-01
"Michigan","2016-08",2016,8,186000,71828,114172,88.5644693361466,"08",2016-08-01
"Michigan","2016-09",2016,9,185000,74371,110629,85.3056047129402,"09",2016-09-01
"Michigan","2017-01",2017,1,181000,77717,103283,79.8424533370439,"01",2017-01-01
"Michigan","2017-10",2017,10,231000,77482,153518,99.5312530390752,"10",2017-10-01
"Michigan","2017-11",2017,11,225000,68203,156797,106.954567313431,"11",2017-11-01
"Michigan","2017-12",2017,12,220000,60384,159616,113.855284181694,"12",2017-12-01
"Michigan","2017-02",2017,2,176000,73621,102379,82.0275537715176,"02",2017-02-01
"Michigan","2017-03",2017,3,184000,83922,100078,74.7068176558849,"03",2017-03-01
"Michigan","2017-04",2017,4,191000,79679,111321,82.2531485634275,"04",2017-04-01
"Michigan","2017-05",2017,5,194000,72260,121740,91.4444527905055,"05",2017-05-01
"Michigan","2017-06",2017,6,198000,80955,117045,83.9167607678658,"06",2017-06-01
"Michigan","2017-07",2017,7,195000,81814,113186,81.7776557544055,"07",2017-07-01
"Michigan","2017-08",2017,8,212000,80375,131625,90.0384779820436,"08",2017-08-01
"Michigan","2017-09",2017,9,216000,75385,140615,96.5149201228615,"09",2017-09-01
"Michigan","2018-01",2018,1,211000,61426,149574,109.808902234001,"01",2018-01-01
"Michigan","2018-10",2018,10,258000,83730,174270,101.992801334387,"10",2018-10-01
"Michigan","2018-11",2018,11,242000,73552,168448,106.76401987628,"11",2018-11-01
"Michigan","2018-12",2018,12,233000,64387,168613,113.396348865283,"12",2018-12-01
"Michigan","2018-02",2018,2,207000,61275,145725,108.638523902712,"02",2018-02-01
"Michigan","2018-03",2018,3,210000,71960,138040,97.914597815293,"03",2018-03-01
"Michigan","2018-04",2018,4,218000,68013,149987,104.881246656621,"04",2018-04-01
"Michigan","2018-05",2018,5,230000,89363,140637,88.0734462038495,"05",2018-05-01
"Michigan","2018-06",2018,6,231000,65606,165394,111.524379142701,"06",2018-06-01
"Michigan","2018-07",2018,7,232000,85682,146318,92.1160153864556,"07",2018-07-01
"Michigan","2018-08",2018,8,240000,77718,162282,102.154740996733,"08",2018-08-01
"Michigan","2018-09",2018,9,249000,71726,177274,110.545450010289,"09",2018-09-01
"Michigan","2019-01",2019,1,224000,69182,154818,105.612213573821,"01",2019-01-01
"Michigan","2019-10",2019,10,239000,92856,146144,88.0767561834049,"10",2019-10-01
"Michigan","2019-11",2019,11,234000,87193,146807,91.4135737702877,"11",2019-11-01
"Michigan","2019-12",2019,12,225000,77483,147517,97.5373822661108,"12",2019-12-01
"Michigan","2019-02",2019,2,217000,58655,158345,114.886361575157,"02",2019-02-01
"Michigan","2019-03",2019,3,223000,80967,142033,93.4529077169561,"03",2019-03-01
"Michigan","2019-04",2019,4,224000,62422,161578,112.82513214767,"04",2019-04-01
"Michigan","2019-05",2019,5,237000,80229,156771,98.8377481251714,"05",2019-05-01
"Michigan","2019-06",2019,6,233000,62838,170162,115.037283918902,"06",2019-06-01
"Michigan","2019-07",2019,7,225000,64365,160635,111.025866984604,"07",2019-07-01
"Michigan","2019-08",2019,8,220000,91448,128552,82.5511802933395,"08",2019-08-01
"Michigan","2019-09",2019,9,216000,118724,97276,58.1231103834801,"09",2019-09-01
"Minnesota","2010-01",2010,1,48000,5495,42505,158.91204785494,"01",2010-01-01
"Minnesota","2010-10",2010,10,50000,20949,29051,81.8926270983382,"10",2010-10-01
"Minnesota","2010-11",2010,11,50000,25147,24853,66.1450224227181,"11",2010-11-01
"Minnesota","2010-12",2010,12,49000,20963,28037,80.1480782699427,"12",2010-12-01
"Minnesota","2010-02",2010,2,46000,11561,34439,119.660881499626,"02",2010-02-01
"Minnesota","2010-03",2010,3,47000,14663,32337,104.88299304283,"03",2010-03-01
"Minnesota","2010-04",2010,4,50000,15932,34068,103.342838075593,"04",2010-04-01
"Minnesota","2010-05",2010,5,53000,20237,32763,89.4711689446591,"05",2010-05-01
"Minnesota","2010-06",2010,6,54000,16026,37974,108.456858880987,"06",2010-06-01
"Minnesota","2010-07",2010,7,50000,20855,29145,82.2666008044598,"07",2010-07-01
"Minnesota","2010-08",2010,8,51000,21671,29329,80.7172049373202,"08",2010-08-01
"Minnesota","2010-09",2010,9,52000,22947,29053,77.5294541475976,"09",2010-09-01
"Minnesota","2011-01",2011,1,53000,26698,26302,66.0041657256142,"01",2011-01-01
"Minnesota","2011-10",2011,10,68000,22007,45993,102.198717877498,"10",2011-10-01
"Minnesota","2011-11",2011,11,66000,17298,48702,116.934380177195,"11",2011-11-01
"Minnesota","2011-12",2011,12,63000,19060,43940,107.092371435535,"12",2011-12-01
"Minnesota","2011-02",2011,2,52000,24251,27749,72.7833077598982,"02",2011-02-01
"Minnesota","2011-03",2011,3,54000,24750,29250,74.2857142857143,"03",2011-03-01
"Minnesota","2011-04",2011,4,59000,19519,39481,100.564194653523,"04",2011-04-01
"Minnesota","2011-05",2011,5,64000,29781,34219,72.9764024695834,"05",2011-05-01
"Minnesota","2011-06",2011,6,64000,23287,40713,93.2853689552854,"06",2011-06-01
"Minnesota","2011-07",2011,7,64000,24592,39408,88.9651435795557,"07",2011-07-01
"Minnesota","2011-08",2011,8,65000,27962,37038,79.68417202728,"08",2011-08-01
"Minnesota","2011-09",2011,9,69000,19619,49381,111.445626784324,"09",2011-09-01
"Minnesota","2012-01",2012,1,65000,21788,43212,99.5805871779509,"01",2012-01-01
"Minnesota","2012-10",2012,10,81000,20298,60702,119.84836818101,"10",2012-10-01
"Minnesota","2012-11",2012,11,82000,17887,64113,128.371059297006,"11",2012-11-01
"Minnesota","2012-12",2012,12,80000,28958,51042,93.6911470474862,"12",2012-12-01
"Minnesota","2012-02",2012,2,64000,26226,37774,83.7319619621839,"02",2012-02-01
"Minnesota","2012-03",2012,3,69000,25574,43426,91.8349652124262,"03",2012-03-01
"Minnesota","2012-04",2012,4,67000,22779,44221,98.5107876006638,"04",2012-04-01
"Minnesota","2012-05",2012,5,67000,22312,44688,100.071658903619,"05",2012-05-01
"Minnesota","2012-06",2012,6,65000,19723,45277,106.882428620327,"06",2012-06-01
"Minnesota","2012-07",2012,7,68000,17089,50911,119.665291635817,"07",2012-07-01
"Minnesota","2012-08",2012,8,70000,15338,54662,128.10705664534,"08",2012-08-01
"Minnesota","2012-09",2012,9,76000,15629,60371,131.772692051643,"09",2012-09-01
"Minnesota","2013-01",2013,1,74000,35893,38107,69.3529160183087,"01",2013-01-01
"Minnesota","2013-10",2013,10,102000,50964,51036,66.729426531733,"10",2013-10-01
"Minnesota","2013-11",2013,11,96000,34459,61541,94.3453498800389,"11",2013-11-01
"Minnesota","2013-12",2013,12,88000,32790,55210,91.4148522228661,"12",2013-12-01
"Minnesota","2013-02",2013,2,74000,30034,43966,84.5223676874868,"02",2013-02-01
"Minnesota","2013-03",2013,3,73000,31150,41850,80.3648583773404,"03",2013-03-01
"Minnesota","2013-04",2013,4,78000,24519,53481,104.333830802095,"04",2013-04-01
"Minnesota","2013-05",2013,5,81000,29751,51249,92.5481485494488,"05",2013-05-01
"Minnesota","2013-06",2013,6,85000,38676,46324,74.9118664898606,"06",2013-06-01
"Minnesota","2013-07",2013,7,83000,42371,40629,64.814031953163,"07",2013-07-01
"Minnesota","2013-08",2013,8,89000,45425,43575,64.8316905337549,"08",2013-08-01
"Minnesota","2013-09",2013,9,94000,49717,44283,61.6252774549984,"09",2013-09-01
"Minnesota","2014-01",2014,1,82000,39386,42614,70.2123803404017,"01",2014-01-01
"Minnesota","2014-10",2014,10,106000,38790,67210,92.8379031701084,"10",2014-10-01
"Minnesota","2014-11",2014,11,103000,30184,72816,109.34646804421,"11",2014-11-01
"Minnesota","2014-12",2014,12,96000,28832,67168,107.613432453217,"12",2014-12-01
"Minnesota","2014-02",2014,2,82000,34200,47800,82.2719449225473,"02",2014-02-01
"Minnesota","2014-03",2014,3,86000,37493,48507,78.558298850947,"03",2014-03-01
"Minnesota","2014-04",2014,4,92000,34276,57724,91.4251322499921,"04",2014-04-01
"Minnesota","2014-05",2014,5,97000,36117,60883,91.4729148042699,"05",2014-05-01
"Minnesota","2014-06",2014,6,97000,28994,68006,107.951172278045,"06",2014-06-01
"Minnesota","2014-07",2014,7,96000,26458,69542,113.576899835045,"07",2014-07-01
"Minnesota","2014-08",2014,8,99000,31600,67400,103.215926493109,"08",2014-08-01
"Minnesota","2014-09",2014,9,107000,37322,69678,96.5590831612644,"09",2014-09-01
"Minnesota","2015-01",2015,1,101000,29019,71981,110.723817288243,"01",2015-01-01
"Minnesota","2015-10",2015,10,112000,40135,71865,94.4753015413941,"10",2015-10-01
"Minnesota","2015-11",2015,11,115000,36597,78403,103.436083827516,"11",2015-11-01
"Minnesota","2015-12",2015,12,112000,35790,76210,103.132823601056,"12",2015-12-01
"Minnesota","2015-02",2015,2,115000,25283,89717,127.908584789319,"02",2015-02-01
"Minnesota","2015-03",2015,3,131000,29381,101619,126.721993253565,"03",2015-03-01
"Minnesota","2015-04",2015,4,137000,30111,106889,127.925749950632,"04",2015-04-01
"Minnesota","2015-05",2015,5,132000,33889,98111,118.285118362278,"05",2015-05-01
"Minnesota","2015-06",2015,6,120000,36203,83797,107.292433564016,"06",2015-06-01
"Minnesota","2015-07",2015,7,118000,40654,77346,97.5027418155231,"07",2015-07-01
"Minnesota","2015-08",2015,8,115000,41090,73910,94.701774617208,"08",2015-08-01
"Minnesota","2015-09",2015,9,116000,37288,78712,102.6981890298,"09",2015-09-01
"Minnesota","2016-01",2016,1,109000,43413,65587,86.0648369889708,"01",2016-01-01
"Minnesota","2016-10",2016,10,122000,53219,68781,78.5086092261684,"10",2016-10-01
"Minnesota","2016-11",2016,11,115000,44409,70591,88.5658902571373,"11",2016-11-01
"Minnesota","2016-12",2016,12,113000,37725,75275,99.883894509869,"12",2016-12-01
"Minnesota","2016-02",2016,2,107000,42425,64575,86.4313200602309,"02",2016-02-01
"Minnesota","2016-03",2016,3,109000,55280,53720,65.4005356708059,"03",2016-03-01
"Minnesota","2016-04",2016,4,120000,44239,75761,92.2570156905485,"04",2016-04-01
"Minnesota","2016-05",2016,5,120000,42540,77460,95.3119232189,"05",2016-05-01
"Minnesota","2016-06",2016,6,122000,44553,77447,92.999825881251,"06",2016-06-01
"Minnesota","2016-07",2016,7,121000,45838,75162,90.1017753749146,"07",2016-07-01
"Minnesota","2016-08",2016,8,128000,45589,82411,94.9495647765699,"08",2016-08-01
"Minnesota","2016-09",2016,9,132000,54321,77679,83.3819054212891,"09",2016-09-01
"Minnesota","2017-01",2017,1,109000,42555,66445,87.684339018838,"01",2017-01-01
"Minnesota","2017-10",2017,10,156000,34665,121335,127.275588073322,"10",2017-10-01
"Minnesota","2017-11",2017,11,158000,31845,126155,132.90315783929,"11",2017-11-01
"Minnesota","2017-12",2017,12,156000,26248,129752,142.390588648435,"12",2017-12-01
"Minnesota","2017-02",2017,2,110000,44745,65255,84.3387508481696,"02",2017-02-01
"Minnesota","2017-03",2017,3,114000,48321,65679,80.9248341249746,"03",2017-03-01
"Minnesota","2017-04",2017,4,132000,45718,86282,97.0998998413216,"04",2017-04-01
"Minnesota","2017-05",2017,5,135000,46046,88954,98.2667388398528,"05",2017-05-01
"Minnesota","2017-06",2017,6,137000,47639,89361,96.7953682591435,"06",2017-06-01
"Minnesota","2017-07",2017,7,133000,44869,88131,99.0965260950475,"07",2017-07-01
"Minnesota","2017-08",2017,8,139000,39683,99317,111.165583743277,"08",2017-08-01
"Minnesota","2017-09",2017,9,149000,34618,114382,124.586914136958,"09",2017-09-01
"Minnesota","2018-01",2018,1,150000,34420,115580,125.344322741568,"01",2018-01-01
"Minnesota","2018-10",2018,10,171000,61980,109020,93.5874323976307,"10",2018-10-01
"Minnesota","2018-11",2018,11,170000,57155,112845,99.3550659241487,"11",2018-11-01
"Minnesota","2018-12",2018,12,166000,49266,116734,108.455585182983,"12",2018-12-01
"Minnesota","2018-02",2018,2,151000,36980,114020,121.310777742313,"02",2018-02-01
"Minnesota","2018-03",2018,3,154000,43046,110954,112.617358383322,"03",2018-03-01
"Minnesota","2018-04",2018,4,163000,69546,93454,80.374635555976,"04",2018-04-01
"Minnesota","2018-05",2018,5,171000,73969,97031,79.2190032208157,"05",2018-05-01
"Minnesota","2018-06",2018,6,169000,49189,119811,109.823134988473,"06",2018-06-01
"Minnesota","2018-07",2018,7,168000,59405,108595,95.5080143356566,"07",2018-07-01
"Minnesota","2018-08",2018,8,167000,53520,113480,102.920370034464,"08",2018-08-01
"Minnesota","2018-09",2018,9,168000,53011,114989,104.057264118076,"09",2018-09-01
"Minnesota","2019-01",2019,1,152000,48140,103860,103.787348855801,"01",2019-01-01
"Minnesota","2019-10",2019,10,134000,63316,70684,71.6454823734517,"10",2019-10-01
"Minnesota","2019-11",2019,11,129000,60892,68108,71.7334063572978,"11",2019-11-01
"Minnesota","2019-12",2019,12,121000,60158,60842,67.1700946135418,"12",2019-12-01
"Minnesota","2019-02",2019,2,145000,44378,100622,106.265775327652,"02",2019-02-01
"Minnesota","2019-03",2019,3,141000,64134,76866,74.9422328819211,"03",2019-03-01
"Minnesota","2019-04",2019,4,149000,52582,96418,95.6613189669713,"04",2019-04-01
"Minnesota","2019-05",2019,5,157000,63998,93002,84.1654675607924,"05",2019-05-01
"Minnesota","2019-06",2019,6,158000,49216,108784,104.995753223689,"06",2019-06-01
"Minnesota","2019-07",2019,7,151000,38775,112225,118.27163746542,"07",2019-07-01
"Minnesota","2019-08",2019,8,142000,53212,88788,90.9657193205336,"08",2019-08-01
"Minnesota","2019-09",2019,9,137000,80904,56096,51.4868933108158,"09",2019-09-01
"Mississippi","2010-01",2010,1,19000,1572,17428,169.434182383823,"01",2010-01-01
"Mississippi","2010-10",2010,10,25000,5546,19454,127.37510639691,"10",2010-10-01
"Mississippi","2010-11",2010,11,22000,5000,17000,125.925925925926,"11",2010-11-01
"Mississippi","2010-12",2010,12,20000,6041,13959,107.207864521332,"12",2010-12-01
"Mississippi","2010-02",2010,2,21000,3673,17327,140.45312689985,"02",2010-02-01
"Mississippi","2010-03",2010,3,22000,4895,17105,127.19836400818,"03",2010-03-01
"Mississippi","2010-04",2010,4,23000,3871,19129,142.376539764058,"04",2010-04-01
"Mississippi","2010-05",2010,5,23000,5964,17036,117.635685678774,"05",2010-05-01
"Mississippi","2010-06",2010,6,24000,5693,18307,123.308523894521,"06",2010-06-01
"Mississippi","2010-07",2010,7,24000,6333,17667,116.486994362575,"07",2010-07-01
"Mississippi","2010-08",2010,8,24000,5875,18125,121.338912133891,"08",2010-08-01
"Mississippi","2010-09",2010,9,25000,6505,18495,117.409934930963,"09",2010-09-01
"Mississippi","2011-01",2011,1,20000,4623,15377,124.899484222069,"01",2011-01-01
"Mississippi","2011-10",2011,10,34000,5543,28457,143.929393318666,"10",2011-10-01
"Mississippi","2011-11",2011,11,33000,6231,26769,136.468609008182,"11",2011-11-01
"Mississippi","2011-12",2011,12,31000,5373,25627,140.912215104611,"12",2011-12-01
"Mississippi","2011-02",2011,2,21000,5256,15744,119.926873857404,"02",2011-02-01
"Mississippi","2011-03",2011,3,23000,6818,16182,108.538466697968,"03",2011-03-01
"Mississippi","2011-04",2011,4,24000,5686,18314,123.384760493162,"04",2011-04-01
"Mississippi","2011-05",2011,5,25000,6736,18264,115.099571464583,"05",2011-05-01
"Mississippi","2011-06",2011,6,26000,6163,19837,123.352921058359,"06",2011-06-01
"Mississippi","2011-07",2011,7,28000,6844,21156,121.432671335094,"07",2011-07-01
"Mississippi","2011-08",2011,8,29000,5791,23209,133.41956253054,"08",2011-08-01
"Mississippi","2011-09",2011,9,33000,5350,27650,144.198174706649,"09",2011-09-01
"Mississippi","2012-01",2012,1,31000,5446,25554,140.229380453273,"01",2012-01-01
"Mississippi","2012-10",2012,10,36000,4860,31140,152.422907488987,"10",2012-10-01
"Mississippi","2012-11",2012,11,34000,4427,29573,153.917818200744,"11",2012-11-01
"Mississippi","2012-12",2012,12,32000,5098,26902,145.032077200927,"12",2012-12-01
"Mississippi","2012-02",2012,2,32000,7951,24049,120.392480788966,"02",2012-02-01
"Mississippi","2012-03",2012,3,33000,6518,26482,134.025001265246,"03",2012-03-01
"Mississippi","2012-04",2012,4,33000,5826,27174,139.978365013136,"04",2012-04-01
"Mississippi","2012-05",2012,5,33000,6547,26453,133.780059170101,"05",2012-05-01
"Mississippi","2012-06",2012,6,33000,4713,28287,150.011932224962,"06",2012-06-01
"Mississippi","2012-07",2012,7,34000,4881,29119,149.785242149122,"07",2012-07-01
"Mississippi","2012-08",2012,8,35000,4234,30766,156.83335882143,"08",2012-08-01
"Mississippi","2012-09",2012,9,36000,4564,31436,154.994576471748,"09",2012-09-01
"Mississippi","2013-01",2013,1,28000,8316,19684,108.40400925212,"01",2013-01-01
"Mississippi","2013-10",2013,10,33000,9586,23414,109.961020053539,"10",2013-10-01
"Mississippi","2013-11",2013,11,28000,8362,19638,108.013860623728,"11",2013-11-01
"Mississippi","2013-12",2013,12,27000,7060,19940,117.087492660012,"12",2013-12-01
"Mississippi","2013-02",2013,2,28000,6416,21584,125.430032543003,"02",2013-02-01
"Mississippi","2013-03",2013,3,27000,7256,19744,115.273236805231,"03",2013-03-01
"Mississippi","2013-04",2013,4,30000,5319,24681,139.760468869447,"04",2013-04-01
"Mississippi","2013-05",2013,5,31000,6082,24918,134.394045628607,"05",2013-05-01
"Mississippi","2013-06",2013,6,32000,10783,21217,99.1842554285581,"06",2013-06-01
"Mississippi","2013-07",2013,7,32000,10095,21905,104.074118066279,"07",2013-07-01
"Mississippi","2013-08",2013,8,34000,11243,22757,100.598987688703,"08",2013-08-01
"Mississippi","2013-09",2013,9,35000,9086,25914,117.561130517625,"09",2013-09-01
"Mississippi","2014-01",2014,1,26000,11138,14862,80.0366201734073,"01",2014-01-01
"Mississippi","2014-10",2014,10,39000,11152,27848,111.054394640293,"10",2014-10-01
"Mississippi","2014-11",2014,11,34000,7529,26471,127.48200052975,"11",2014-11-01
"Mississippi","2014-12",2014,12,33000,8018,24982,121.809937100785,"12",2014-12-01
"Mississippi","2014-02",2014,2,28000,9881,18119,95.6627332963755,"02",2014-02-01
"Mississippi","2014-03",2014,3,29000,10942,18058,90.4211106103851,"03",2014-03-01
"Mississippi","2014-04",2014,4,29000,10233,18767,95.6694619325568,"04",2014-04-01
"Mississippi","2014-05",2014,5,30000,10636,19364,95.3046559700758,"05",2014-05-01
"Mississippi","2014-06",2014,6,32000,10616,21384,100.35667354984,"06",2014-06-01
"Mississippi","2014-07",2014,7,34000,8231,25769,122.038313087542,"07",2014-07-01
"Mississippi","2014-08",2014,8,39000,9200,29800,123.651452282158,"08",2014-08-01
"Mississippi","2014-09",2014,9,39000,11934,27066,106.278713629403,"09",2014-09-01
"Mississippi","2015-01",2015,1,33000,8753,24247,116.144947668431,"01",2015-01-01
"Mississippi","2015-10",2015,10,45000,13707,31293,106.607389238081,"10",2015-10-01
"Mississippi","2015-11",2015,11,42000,9449,32551,126.536958930203,"11",2015-11-01
"Mississippi","2015-12",2015,12,41000,9872,31128,122.377732347853,"12",2015-12-01
"Mississippi","2015-02",2015,2,35000,7132,27868,132.288996487231,"02",2015-02-01
"Mississippi","2015-03",2015,3,36000,9455,26545,116.79683203168,"03",2015-03-01
"Mississippi","2015-04",2015,4,40000,10648,29352,115.905860053704,"04",2015-04-01
"Mississippi","2015-05",2015,5,43000,11299,31701,116.76458129984,"05",2015-05-01
"Mississippi","2015-06",2015,6,43000,11390,31610,116.234601948888,"06",2015-06-01
"Mississippi","2015-07",2015,7,44000,11908,32092,114.802890462903,"07",2015-07-01
"Mississippi","2015-08",2015,8,44000,11318,32682,118.160454101739,"08",2015-08-01
"Mississippi","2015-09",2015,9,45000,10062,34938,126.9042170644,"09",2015-09-01
"Mississippi","2016-01",2016,1,42000,12692,29308,107.174723908433,"01",2016-01-01
"Mississippi","2016-10",2016,10,41000,13459,27541,101.143979874768,"10",2016-10-01
"Mississippi","2016-11",2016,11,38000,10953,27047,110.501909995302,"11",2016-11-01
"Mississippi","2016-12",2016,12,38000,10103,27897,115.988607779141,"12",2016-12-01
"Mississippi","2016-02",2016,2,44000,11184,32816,118.933024064946,"02",2016-02-01
"Mississippi","2016-03",2016,3,45000,14172,30828,104.197931454066,"03",2016-03-01
"Mississippi","2016-04",2016,4,44000,13415,30585,106.540102760603,"04",2016-04-01
"Mississippi","2016-05",2016,5,43000,11758,31242,114.109353884364,"05",2016-05-01
"Mississippi","2016-06",2016,6,42000,11128,30872,116.217437132962,"06",2016-06-01
"Mississippi","2016-07",2016,7,41000,12481,28519,106.650960154073,"07",2016-07-01
"Mississippi","2016-08",2016,8,42000,12331,29669,109.215733190996,"08",2016-08-01
"Mississippi","2016-09",2016,9,43000,13888,29112,102.348474194909,"09",2016-09-01
"Mississippi","2017-01",2017,1,37000,11351,25649,106.095013546773,"01",2017-01-01
"Mississippi","2017-10",2017,10,44000,9690,34310,127.807785434904,"10",2017-10-01
"Mississippi","2017-11",2017,11,41000,8229,32771,133.136972109935,"11",2017-11-01
"Mississippi","2017-12",2017,12,40000,7991,32009,133.395845054281,"12",2017-12-01
"Mississippi","2017-02",2017,2,40000,11814,28186,108.796850272127,"02",2017-02-01
"Mississippi","2017-03",2017,3,40000,15376,24624,88.9338341519792,"03",2017-03-01
"Mississippi","2017-04",2017,4,45000,10222,34778,125.957046104813,"04",2017-04-01
"Mississippi","2017-05",2017,5,45000,10324,34676,125.356084158774,"05",2017-05-01
"Mississippi","2017-06",2017,6,44000,10480,33520,123.054331864905,"06",2017-06-01
"Mississippi","2017-07",2017,7,43000,13116,29884,106.507947822368,"07",2017-07-01
"Mississippi","2017-08",2017,8,46000,10477,35523,125.796341873683,"08",2017-08-01
"Mississippi","2017-09",2017,9,47000,8933,38067,136.116425008492,"09",2017-09-01
"Mississippi","2018-01",2018,1,42000,10961,31039,117.214554105851,"01",2018-01-01
"Mississippi","2018-10",2018,10,59000,10015,48985,141.95464754039,"10",2018-10-01
"Mississippi","2018-11",2018,11,56000,8650,47350,146.481051817479,"11",2018-11-01
"Mississippi","2018-12",2018,12,56000,9277,46723,143.153024801998,"12",2018-12-01
"Mississippi","2018-02",2018,2,44000,11262,32738,118.482863450472,"02",2018-02-01
"Mississippi","2018-03",2018,3,46000,12572,33428,114.14327665096,"03",2018-03-01
"Mississippi","2018-04",2018,4,48000,26976,21024,56.0819462227913,"04",2018-04-01
"Mississippi","2018-05",2018,5,49000,19631,29369,85.5852311637598,"05",2018-05-01
"Mississippi","2018-06",2018,6,49000,10911,38089,127.15194204737,"06",2018-06-01
"Mississippi","2018-07",2018,7,50000,10435,39565,130.934061388268,"07",2018-07-01
"Mississippi","2018-08",2018,8,55000,9775,45225,139.63720571208,"08",2018-08-01
"Mississippi","2018-09",2018,9,57000,8502,48498,148.080974626729,"09",2018-09-01
"Mississippi","2019-01",2019,1,53000,9432,43568,139.569451563301,"01",2019-01-01
"Mississippi","2019-10",2019,10,58000,13967,44033,122.369975127489,"10",2019-10-01
"Mississippi","2019-11",2019,11,54000,14744,39256,114.209240079134,"11",2019-11-01
"Mississippi","2019-12",2019,12,49000,12457,36543,118.922173226809,"12",2019-12-01
"Mississippi","2019-02",2019,2,53000,8900,44100,142.48788368336,"02",2019-02-01
"Mississippi","2019-03",2019,3,52000,11691,40309,126.576753387449,"03",2019-03-01
"Mississippi","2019-04",2019,4,53000,11019,41981,131.151689342227,"04",2019-04-01
"Mississippi","2019-05",2019,5,53000,13435,39565,119.108903439452,"05",2019-05-01
"Mississippi","2019-06",2019,6,54000,10020,43980,137.394564198688,"06",2019-06-01
"Mississippi","2019-07",2019,7,52000,8428,43572,144.211292778182,"07",2019-07-01
"Mississippi","2019-08",2019,8,55000,13143,41857,122.850476204452,"08",2019-08-01
"Mississippi","2019-09",2019,9,56000,28675,27325,64.5408916445232,"09",2019-09-01
"Missouri","2010-01",2010,1,42000,5258,36742,155.495365863981,"01",2010-01-01
"Missouri","2010-10",2010,10,53000,20782,32218,87.3329538369792,"10",2010-10-01
"Missouri","2010-11",2010,11,53000,19237,33763,93.4784113404488,"11",2010-11-01
"Missouri","2010-12",2010,12,52000,22818,29182,78.0079659974872,"12",2010-12-01
"Missouri","2010-02",2010,2,45000,12168,32832,114.861460957179,"02",2010-02-01
"Missouri","2010-03",2010,3,51000,12671,38329,120.397041039092,"03",2010-03-01
"Missouri","2010-04",2010,4,56000,16562,39438,108.701524213776,"04",2010-04-01
"Missouri","2010-05",2010,5,56000,19237,36763,97.7258529712774,"05",2010-05-01
"Missouri","2010-06",2010,6,59000,15626,43374,116.243668426554,"06",2010-06-01
"Missouri","2010-07",2010,7,56000,20724,35276,91.9555810437412,"07",2010-07-01
"Missouri","2010-08",2010,8,56000,20666,35334,92.1764537082931,"08",2010-08-01
"Missouri","2010-09",2010,9,52000,19878,32122,89.3792259105707,"09",2010-09-01
"Missouri","2011-01",2011,1,53000,19985,33015,90.4706446530109,"01",2011-01-01
"Missouri","2011-10",2011,10,71000,35805,35195,65.905154253078,"10",2011-10-01
"Missouri","2011-11",2011,11,66000,26698,39302,84.7957884744008,"11",2011-11-01
"Missouri","2011-12",2011,12,60000,44126,15874,30.4899832894762,"12",2011-12-01
"Missouri","2011-02",2011,2,60000,16927,43073,111.984088811471,"02",2011-02-01
"Missouri","2011-03",2011,3,70000,26207,43793,91.0391135780141,"03",2011-03-01
"Missouri","2011-04",2011,4,75000,16839,58161,126.658609087643,"04",2011-04-01
"Missouri","2011-05",2011,5,72000,24128,47872,99.6005326231691,"05",2011-05-01
"Missouri","2011-06",2011,6,70000,28854,41146,83.245999150262,"06",2011-06-01
"Missouri","2011-07",2011,7,74000,30663,43337,82.8124552133992,"07",2011-07-01
"Missouri","2011-08",2011,8,76000,25630,50370,99.1242743284463,"08",2011-08-01
"Missouri","2011-09",2011,9,76000,30656,45344,85.028502850285,"09",2011-09-01
"Missouri","2012-01",2012,1,58000,27375,30625,71.7423133235725,"01",2012-01-01
"Missouri","2012-10",2012,10,74000,21054,52946,111.401939949923,"10",2012-10-01
"Missouri","2012-11",2012,11,73000,20944,52056,110.82346930086,"11",2012-11-01
"Missouri","2012-12",2012,12,73000,21900,51100,107.692307692308,"12",2012-12-01
"Missouri","2012-02",2012,2,62000,29509,32491,71.0115944879739,"02",2012-02-01
"Missouri","2012-03",2012,3,73000,38269,34731,62.4270911035419,"03",2012-03-01
"Missouri","2012-04",2012,4,74000,28867,45133,87.7502017167799,"04",2012-04-01
"Missouri","2012-05",2012,5,75000,22834,52166,106.641862747102,"05",2012-05-01
"Missouri","2012-06",2012,6,73000,19814,53186,114.607710043743,"06",2012-06-01
"Missouri","2012-07",2012,7,77000,19513,57487,119.127993120098,"07",2012-07-01
"Missouri","2012-08",2012,8,77000,24112,52888,104.61270670148,"08",2012-08-01
"Missouri","2012-09",2012,9,75000,18862,56138,119.6181628348,"09",2012-09-01
"Missouri","2013-01",2013,1,69000,30421,38579,77.607346536446,"01",2013-01-01
"Missouri","2013-10",2013,10,92000,28696,63304,104.898256777358,"10",2013-10-01
"Missouri","2013-11",2013,11,88000,23670,64330,115.214471209815,"11",2013-11-01
"Missouri","2013-12",2013,12,79000,23061,55939,109.618757409784,"12",2013-12-01
"Missouri","2013-02",2013,2,74000,22065,51935,108.12470722948,"02",2013-02-01
"Missouri","2013-03",2013,3,74000,23832,50168,102.559489737509,"03",2013-03-01
"Missouri","2013-04",2013,4,80000,18142,61858,126.058160624401,"04",2013-04-01
"Missouri","2013-05",2013,5,77000,19793,57207,118.204828861591,"05",2013-05-01
"Missouri","2013-06",2013,6,81000,30809,50191,89.7798924952374,"06",2013-06-01
"Missouri","2013-07",2013,7,79000,37684,41316,70.8169072023585,"07",2013-07-01
"Missouri","2013-08",2013,8,85000,37004,47996,78.6793875610636,"08",2013-08-01
"Missouri","2013-09",2013,9,87000,27507,59493,103.911551258875,"09",2013-09-01
"Missouri","2014-01",2014,1,74000,32213,41787,78.6852833457298,"01",2014-01-01
"Missouri","2014-10",2014,10,1e+05,28922,71078,110.265121546361,"10",2014-10-01
"Missouri","2014-11",2014,11,84000,20225,63775,122.379467498201,"11",2014-11-01
"Missouri","2014-12",2014,12,81000,20690,60310,118.615399744321,"12",2014-12-01
"Missouri","2014-02",2014,2,71000,25766,45234,93.4915156149887,"02",2014-02-01
"Missouri","2014-03",2014,3,82000,33460,48540,84.081067036203,"03",2014-03-01
"Missouri","2014-04",2014,4,87000,34333,52667,86.8139747636669,"04",2014-04-01
"Missouri","2014-05",2014,5,93000,34543,58457,91.6663399794579,"05",2014-05-01
"Missouri","2014-06",2014,6,89000,29040,59960,101.592680447306,"06",2014-06-01
"Missouri","2014-07",2014,7,89000,25496,63504,110.927892677473,"07",2014-07-01
"Missouri","2014-08",2014,8,99000,27304,71696,113.529262731188,"08",2014-08-01
"Missouri","2014-09",2014,9,1e+05,28986,71014,110.111174856186,"09",2014-09-01
"Missouri","2015-01",2015,1,88000,21124,66876,122.568820791027,"01",2015-01-01
"Missouri","2015-10",2015,10,112000,28438,83562,119.001979521212,"10",2015-10-01
"Missouri","2015-11",2015,11,108000,23830,84170,127.694758400971,"11",2015-11-01
"Missouri","2015-12",2015,12,104000,24278,79722,124.295670340978,"12",2015-12-01
"Missouri","2015-02",2015,2,98000,18060,79940,137.756332931242,"02",2015-02-01
"Missouri","2015-03",2015,3,107000,22249,84751,131.143761267012,"03",2015-03-01
"Missouri","2015-04",2015,4,109000,24319,84681,127.0351562793,"04",2015-04-01
"Missouri","2015-05",2015,5,111000,29792,81208,115.358827206091,"05",2015-05-01
"Missouri","2015-06",2015,6,113000,27895,85105,120.806274175805,"06",2015-06-01
"Missouri","2015-07",2015,7,115000,31100,83900,114.852840520192,"07",2015-07-01
"Missouri","2015-08",2015,8,119000,29805,89195,119.881724404422,"08",2015-08-01
"Missouri","2015-09",2015,9,119000,25473,93527,129.473327196085,"09",2015-09-01
"Missouri","2016-01",2016,1,108000,31066,76934,110.643866940877,"01",2016-01-01
"Missouri","2016-10",2016,10,113000,37326,75674,100.679855780105,"10",2016-10-01
"Missouri","2016-11",2016,11,111000,31923,79077,110.656787221091,"11",2016-11-01
"Missouri","2016-12",2016,12,107000,28779,78221,115.218111784591,"12",2016-12-01
"Missouri","2016-02",2016,2,115000,27348,87652,123.151712704077,"02",2016-02-01
"Missouri","2016-03",2016,3,125000,33906,91094,114.651429146791,"03",2016-03-01
"Missouri","2016-04",2016,4,121000,31851,89149,116.648239134844,"04",2016-04-01
"Missouri","2016-05",2016,5,110000,29766,80234,114.811899889816,"05",2016-05-01
"Missouri","2016-06",2016,6,101000,27581,73419,114.198831864739,"06",2016-06-01
"Missouri","2016-07",2016,7,105000,31381,73619,107.960786326541,"07",2016-07-01
"Missouri","2016-08",2016,8,114000,29571,84429,117.612888396682,"08",2016-08-01
"Missouri","2016-09",2016,9,116000,39676,76324,98.0549346077751,"09",2016-09-01
"Missouri","2017-01",2017,1,107000,32133,74867,107.619328268635,"01",2017-01-01
"Missouri","2017-10",2017,10,138000,28015,109985,132.500075294401,"10",2017-10-01
"Missouri","2017-11",2017,11,133000,25642,107358,135.346251307976,"11",2017-11-01
"Missouri","2017-12",2017,12,127000,21134,105866,142.932750077632,"12",2017-12-01
"Missouri","2017-02",2017,2,110000,38193,71807,96.910110464057,"02",2017-02-01
"Missouri","2017-03",2017,3,115000,37902,77098,100.846293704464,"03",2017-03-01
"Missouri","2017-04",2017,4,123000,34618,88382,112.147089799388,"04",2017-04-01
"Missouri","2017-05",2017,5,120000,32178,87822,115.420100145882,"05",2017-05-01
"Missouri","2017-06",2017,6,122000,37441,84559,106.069329720712,"06",2017-06-01
"Missouri","2017-07",2017,7,123000,32550,90450,116.297010607522,"07",2017-07-01
"Missouri","2017-08",2017,8,130000,33671,96329,117.710529049129,"08",2017-08-01
"Missouri","2017-09",2017,9,135000,27697,107303,131.905320934006,"09",2017-09-01
"Missouri","2018-01",2018,1,122000,30244,91756,120.538083602638,"01",2018-01-01
"Missouri","2018-10",2018,10,169000,51515,117485,106.55510962973,"10",2018-10-01
"Missouri","2018-11",2018,11,175000,48824,126176,112.745728786904,"11",2018-11-01
"Missouri","2018-12",2018,12,171000,40412,130588,123.538871965641,"12",2018-12-01
"Missouri","2018-02",2018,2,128000,32365,95635,119.271661522153,"02",2018-02-01
"Missouri","2018-03",2018,3,142000,41005,100995,110.374033496353,"03",2018-03-01
"Missouri","2018-04",2018,4,156000,42662,113338,114.101337950891,"04",2018-04-01
"Missouri","2018-05",2018,5,165000,52958,112042,102.810633241267,"05",2018-05-01
"Missouri","2018-06",2018,6,162000,42993,119007,116.108354919436,"06",2018-06-01
"Missouri","2018-07",2018,7,159000,52670,106330,100.467709169934,"07",2018-07-01
"Missouri","2018-08",2018,8,158000,48383,109617,106.226772553941,"08",2018-08-01
"Missouri","2018-09",2018,9,165000,45765,119235,113.144971888122,"09",2018-09-01
"Missouri","2019-01",2019,1,168000,41661,126339,120.517406670769,"01",2019-01-01
"Missouri","2019-10",2019,10,139000,70187,68813,65.7908952277149,"10",2019-10-01
"Missouri","2019-11",2019,11,132000,61007,70993,73.5652074795215,"11",2019-11-01
"Missouri","2019-12",2019,12,120000,58556,61444,68.8232263267546,"12",2019-12-01
"Missouri","2019-02",2019,2,155000,37847,117153,121.498389915321,"02",2019-02-01
"Missouri","2019-03",2019,3,156000,51628,104372,100.537499759185,"03",2019-03-01
"Missouri","2019-04",2019,4,162000,44159,117841,114.32050019645,"04",2019-04-01
"Missouri","2019-05",2019,5,167000,55041,111959,100.84533937426,"05",2019-05-01
"Missouri","2019-06",2019,6,164000,39898,124102,121.729492197079,"06",2019-06-01
"Missouri","2019-07",2019,7,165000,38082,126918,124.99187520312,"07",2019-07-01
"Missouri","2019-08",2019,8,162000,43022,118978,116.06364195062,"08",2019-08-01
"Missouri","2019-09",2019,9,156000,76079,79921,68.8739610218934,"09",2019-09-01
"Montana","2010-01",2010,1,10000,605,9395,177.180575200377,"01",2010-01-01
"Montana","2010-10",2010,10,13000,3044,9956,124.108701072052,"10",2010-10-01
"Montana","2010-11",2010,11,12000,2820,9180,123.886639676113,"11",2010-11-01
"Montana","2010-12",2010,12,12000,2972,9028,120.598450440823,"12",2010-12-01
"Montana","2010-02",2010,2,10000,2619,7381,116.982328235201,"02",2010-02-01
"Montana","2010-03",2010,3,11000,1820,9180,143.213728549142,"03",2010-03-01
"Montana","2010-04",2010,4,13000,1971,11029,147.338187161846,"04",2010-04-01
"Montana","2010-05",2010,5,14000,2999,11001,129.431143008412,"05",2010-05-01
"Montana","2010-06",2010,6,14000,2315,11685,143.242414955562,"06",2010-06-01
"Montana","2010-07",2010,7,14000,3117,10883,127.160133200911,"07",2010-07-01
"Montana","2010-08",2010,8,13000,2903,10097,126.982330377916,"08",2010-08-01
"Montana","2010-09",2010,9,12000,2818,9182,123.930354973681,"09",2010-09-01
"Montana","2011-01",2011,1,10000,2782,7218,112.940071976217,"01",2011-01-01
"Montana","2011-10",2011,10,15000,2962,12038,134.03852577664,"10",2011-10-01
"Montana","2011-11",2011,11,14000,2957,11043,130.24709559474,"11",2011-11-01
"Montana","2011-12",2011,12,13000,2375,10625,138.211382113821,"12",2011-12-01
"Montana","2011-02",2011,2,10000,2253,7747,126.45066514323,"02",2011-02-01
"Montana","2011-03",2011,3,12000,4055,7945,98.9722827779508,"03",2011-03-01
"Montana","2011-04",2011,4,13000,4045,8955,105.07480199472,"04",2011-04-01
"Montana","2011-05",2011,5,15000,3307,11693,127.743486098214,"05",2011-05-01
"Montana","2011-06",2011,6,16000,3212,12788,133.125130127004,"06",2011-06-01
"Montana","2011-07",2011,7,17000,3029,13971,139.507713814968,"07",2011-07-01
"Montana","2011-08",2011,8,16000,2926,13074,138.159146148156,"08",2011-08-01
"Montana","2011-09",2011,9,15000,2566,12434,141.568939997723,"09",2011-09-01
"Montana","2012-01",2012,1,11000,4001,6999,93.3137790813946,"01",2012-01-01
"Montana","2012-10",2012,10,15000,3185,11815,129.942260104482,"10",2012-10-01
"Montana","2012-11",2012,11,14000,4191,9809,107.844538508053,"11",2012-11-01
"Montana","2012-12",2012,12,14000,2991,11009,129.586251544936,"12",2012-12-01
"Montana","2012-02",2012,2,11000,4700,6300,80.2547770700637,"02",2012-02-01
"Montana","2012-03",2012,3,11000,4978,6022,75.3786456377519,"03",2012-03-01
"Montana","2012-04",2012,4,13000,4106,8894,103.986905179469,"04",2012-04-01
"Montana","2012-05",2012,5,16000,3786,12214,123.461033053674,"05",2012-05-01
"Montana","2012-06",2012,6,18000,3723,14277,131.445932882199,"06",2012-06-01
"Montana","2012-07",2012,7,17000,2888,14112,141.914722445696,"07",2012-07-01
"Montana","2012-08",2012,8,16000,2656,13344,143.053173241853,"08",2012-08-01
"Montana","2012-09",2012,9,15000,3411,11589,125.892129705068,"09",2012-09-01
"Montana","2013-01",2013,1,14000,4355,9645,105.093979842005,"01",2013-01-01
"Montana","2013-10",2013,10,18000,6170,11830,97.8899462143153,"10",2013-10-01
"Montana","2013-11",2013,11,16000,4441,11559,113.096228168876,"11",2013-11-01
"Montana","2013-12",2013,12,16000,4519,11481,111.90603830596,"12",2013-12-01
"Montana","2013-02",2013,2,14000,3223,10777,125.146606282297,"02",2013-02-01
"Montana","2013-03",2013,3,15000,4590,10410,106.278713629403,"03",2013-03-01
"Montana","2013-04",2013,4,17000,2689,14311,145.370511453096,"04",2013-04-01
"Montana","2013-05",2013,5,20000,4001,15999,133.319445023124,"05",2013-05-01
"Montana","2013-06",2013,6,21000,10697,10303,65.0093068744676,"06",2013-06-01
"Montana","2013-07",2013,7,20000,8654,11346,79.1931318489565,"07",2013-07-01
"Montana","2013-08",2013,8,19000,9312,9688,68.4374116982198,"08",2013-08-01
"Montana","2013-09",2013,9,18000,6799,11201,90.33428767289,"09",2013-09-01
"Montana","2014-01",2014,1,15000,6531,8469,78.6679671171799,"01",2014-01-01
"Montana","2014-10",2014,10,21000,5288,15712,119.537431527693,"10",2014-10-01
"Montana","2014-11",2014,11,19000,3537,15463,137.223232905888,"11",2014-11-01
"Montana","2014-12",2014,12,18000,4144,13856,125.14450867052,"12",2014-12-01
"Montana","2014-02",2014,2,16000,5989,10011,91.0546182182,"02",2014-02-01
"Montana","2014-03",2014,3,16000,5919,10081,91.9841233632921,"03",2014-03-01
"Montana","2014-04",2014,4,19000,6817,12183,94.3796723089437,"04",2014-04-01
"Montana","2014-05",2014,5,21000,7039,13961,99.5827240629124,"05",2014-05-01
"Montana","2014-06",2014,6,24000,5670,18330,123.55915065723,"06",2014-06-01
"Montana","2014-07",2014,7,24000,4753,19247,133.878204013494,"07",2014-07-01
"Montana","2014-08",2014,8,24000,5496,18504,125.46786004882,"08",2014-08-01
"Montana","2014-09",2014,9,22000,5526,16474,119.697740318245,"09",2014-09-01
"Montana","2015-01",2015,1,19000,5140,13860,114.830157415079,"01",2015-01-01
"Montana","2015-10",2015,10,21000,8252,12748,87.1598523177902,"10",2015-10-01
"Montana","2015-11",2015,11,20000,5566,14434,112.915591019323,"11",2015-11-01
"Montana","2015-12",2015,12,20000,5041,14959,119.476059262809,"12",2015-12-01
"Montana","2015-02",2015,2,20000,5649,14351,111.90299816757,"02",2015-02-01
"Montana","2015-03",2015,3,21000,6027,14973,110.800310800311,"03",2015-03-01
"Montana","2015-04",2015,4,23000,5929,17071,118.019979950914,"04",2015-04-01
"Montana","2015-05",2015,5,24000,6923,17077,110.448533454063,"05",2015-05-01
"Montana","2015-06",2015,6,25000,6359,18641,118.887719633917,"06",2015-06-01
"Montana","2015-07",2015,7,24000,6735,17265,112.347486578819,"07",2015-07-01
"Montana","2015-08",2015,8,23000,6414,16586,112.776229006595,"08",2015-08-01
"Montana","2015-09",2015,9,23000,5971,17029,117.558938248593,"09",2015-09-01
"Montana","2016-01",2016,1,21000,6453,14547,105.977488799038,"01",2016-01-01
"Montana","2016-10",2016,10,23000,7243,15757,104.202625400919,"10",2016-10-01
"Montana","2016-11",2016,11,22000,6361,15639,110.285250872677,"11",2016-11-01
"Montana","2016-12",2016,12,22000,6077,15923,113.423798838907,"12",2016-12-01
"Montana","2016-02",2016,2,21000,5609,15391,115.682663760382,"02",2016-02-01
"Montana","2016-03",2016,3,21000,9285,11715,77.3650321941555,"03",2016-03-01
"Montana","2016-04",2016,4,22000,7688,14312,96.4160603610887,"04",2016-04-01
"Montana","2016-05",2016,5,26000,5643,20357,128.666687735044,"05",2016-05-01
"Montana","2016-06",2016,6,28000,7186,20814,118.308418120844,"06",2016-06-01
"Montana","2016-07",2016,7,27000,7334,19666,114.556998893225,"07",2016-07-01
"Montana","2016-08",2016,8,25000,5580,19420,127.011118378025,"08",2016-08-01
"Montana","2016-09",2016,9,23000,8963,14037,87.8328066827269,"09",2016-09-01
"Montana","2017-01",2017,1,20000,6764,13236,98.9089822149156,"01",2017-01-01
"Montana","2017-10",2017,10,25000,4913,20087,134.302811486645,"10",2017-10-01
"Montana","2017-11",2017,11,23000,5105,17895,127.343888987725,"11",2017-11-01
"Montana","2017-12",2017,12,22000,3557,18443,144.328364048989,"12",2017-12-01
"Montana","2017-02",2017,2,20000,7586,12414,90.0021750163126,"02",2017-02-01
"Montana","2017-03",2017,3,20000,10922,9078,58.7154776534506,"03",2017-03-01
"Montana","2017-04",2017,4,23000,5792,17208,119.533203667685,"04",2017-04-01
"Montana","2017-05",2017,5,26000,5946,20054,125.549364552683,"05",2017-05-01
"Montana","2017-06",2017,6,28000,5797,22203,131.390360091132,"06",2017-06-01
"Montana","2017-07",2017,7,28000,5617,22383,133.164767825802,"07",2017-07-01
"Montana","2017-08",2017,8,27000,4281,22719,145.257504555481,"08",2017-08-01
"Montana","2017-09",2017,9,26000,4548,21452,140.447819824538,"09",2017-09-01
"Montana","2018-01",2018,1,21000,5352,15648,118.761384335155,"01",2018-01-01
"Montana","2018-10",2018,10,28000,6044,21956,128.986018094231,"10",2018-10-01
"Montana","2018-11",2018,11,26000,4784,21216,137.837837837838,"11",2018-11-01
"Montana","2018-12",2018,12,25000,4673,20327,137.006706433458,"12",2018-12-01
"Montana","2018-02",2018,2,21000,6632,14368,103.995367689635,"02",2018-02-01
"Montana","2018-03",2018,3,22000,7901,14099,94.3045383097555,"03",2018-03-01
"Montana","2018-04",2018,4,23000,14967,8033,42.3156952089973,"04",2018-04-01
"Montana","2018-05",2018,5,27000,8656,18344,102.894323536011,"05",2018-05-01
"Montana","2018-06",2018,6,30000,6224,23776,131.272084805654,"06",2018-06-01
"Montana","2018-07",2018,7,31000,5225,25775,142.305037957212,"07",2018-07-01
"Montana","2018-08",2018,8,31000,5474,25526,139.968196523551,"08",2018-08-01
"Montana","2018-09",2018,9,29000,4825,24175,142.941611234294,"09",2018-09-01
"Montana","2019-01",2019,1,25000,5011,19989,133.2111559095,"01",2019-01-01
"Montana","2019-10",2019,10,26000,6052,19948,124.472731810807,"10",2019-10-01
"Montana","2019-11",2019,11,24000,8425,15575,96.0678488820355,"11",2019-11-01
"Montana","2019-12",2019,12,23000,6670,16330,110.077519379845,"12",2019-12-01
"Montana","2019-02",2019,2,25000,4225,20775,142.172797262618,"02",2019-02-01
"Montana","2019-03",2019,3,24000,7252,16748,107.180340458211,"03",2019-03-01
"Montana","2019-04",2019,4,25000,5768,19232,125.013000520021,"04",2019-04-01
"Montana","2019-05",2019,5,29000,6362,22638,128.035744584582,"05",2019-05-01
"Montana","2019-06",2019,6,32000,4887,27113,147.005720172418,"06",2019-06-01
"Montana","2019-07",2019,7,32000,3977,28023,155.78286127248,"07",2019-07-01
"Montana","2019-08",2019,8,30000,6201,23799,131.482555730505,"08",2019-08-01
"Montana","2019-09",2019,9,28000,10833,17167,88.4144928282646,"09",2019-09-01
"Nebraska","2010-01",2010,1,18000,2591,15409,149.667330387062,"01",2010-01-01
"Nebraska","2010-10",2010,10,19000,8449,10551,76.8771175634814,"10",2010-10-01
"Nebraska","2010-11",2010,11,19000,9116,9884,70.3087210129464,"11",2010-11-01
"Nebraska","2010-12",2010,12,18000,10292,7708,54.488901456242,"12",2010-12-01
"Nebraska","2010-02",2010,2,18000,4073,13927,126.190368323291,"02",2010-02-01
"Nebraska","2010-03",2010,3,18000,9579,8421,61.0682040683128,"03",2010-03-01
"Nebraska","2010-04",2010,4,18000,5064,12936,112.174817898023,"04",2010-04-01
"Nebraska","2010-05",2010,5,19000,11348,7652,50.4283643073679,"05",2010-05-01
"Nebraska","2010-06",2010,6,19000,7687,11313,84.7828530745307,"06",2010-06-01
"Nebraska","2010-07",2010,7,19000,14117,4883,29.4893861158921,"07",2010-07-01
"Nebraska","2010-08",2010,8,19000,13011,5989,37.4183874293212,"08",2010-08-01
"Nebraska","2010-09",2010,9,19000,13783,5217,31.8274715553793,"09",2010-09-01
"Nebraska","2011-01",2011,1,19000,9501,9499,66.6573102698151,"01",2011-01-01
"Nebraska","2011-10",2011,10,29000,8405,20595,110.118968052399,"10",2011-10-01
"Nebraska","2011-11",2011,11,28000,7591,20409,114.686297097581,"11",2011-11-01
"Nebraska","2011-12",2011,12,27000,8813,18187,101.566470276157,"12",2011-12-01
"Nebraska","2011-02",2011,2,20000,5611,14389,112.365780328765,"02",2011-02-01
"Nebraska","2011-03",2011,3,22000,13505,8495,47.8524151527954,"03",2011-03-01
"Nebraska","2011-04",2011,4,24000,9143,14857,89.6539239055004,"04",2011-04-01
"Nebraska","2011-05",2011,5,25000,9789,15211,87.4471815803846,"05",2011-05-01
"Nebraska","2011-06",2011,6,26000,8384,17616,102.466263378316,"06",2011-06-01
"Nebraska","2011-07",2011,7,27000,9380,17620,96.866410115448,"07",2011-07-01
"Nebraska","2011-08",2011,8,28000,7391,20609,116.464637902292,"08",2011-08-01
"Nebraska","2011-09",2011,9,29000,9749,19251,99.362564195205,"09",2011-09-01
"Nebraska","2012-01",2012,1,27000,14061,12939,63.0233067874626,"01",2012-01-01
"Nebraska","2012-10",2012,10,27000,6385,20615,123.498577205332,"10",2012-10-01
"Nebraska","2012-11",2012,11,26000,5414,20586,131.062583561469,"11",2012-11-01
"Nebraska","2012-12",2012,12,26000,6283,19717,122.150977294551,"12",2012-12-01
"Nebraska","2012-02",2012,2,28000,10982,17018,87.3120927607614,"02",2012-02-01
"Nebraska","2012-03",2012,3,30000,12254,17746,83.9967813698111,"03",2012-03-01
"Nebraska","2012-04",2012,4,28000,10190,17810,93.2704896569783,"04",2012-04-01
"Nebraska","2012-05",2012,5,28000,8896,19104,103.555941023417,"05",2012-05-01
"Nebraska","2012-06",2012,6,25000,6354,18646,118.93857243095,"06",2012-06-01
"Nebraska","2012-07",2012,7,26000,5037,20963,135.083932081065,"07",2012-07-01
"Nebraska","2012-08",2012,8,26000,5619,20381,128.916158006262,"08",2012-08-01
"Nebraska","2012-09",2012,9,27000,4539,22461,142.433177970132,"09",2012-09-01
"Nebraska","2013-01",2013,1,24000,9246,14754,88.7565421404079,"01",2013-01-01
"Nebraska","2013-10",2013,10,37000,10752,26248,109.934662422516,"10",2013-10-01
"Nebraska","2013-11",2013,11,34000,11337,22663,99.9757372565454,"11",2013-11-01
"Nebraska","2013-12",2013,12,30000,12462,17538,82.6056238519147,"12",2013-12-01
"Nebraska","2013-02",2013,2,24000,7211,16789,107.5838646631,"02",2013-02-01
"Nebraska","2013-03",2013,3,24000,9496,14504,86.6013852400287,"03",2013-03-01
"Nebraska","2013-04",2013,4,25000,6841,18159,114.060488049998,"04",2013-04-01
"Nebraska","2013-05",2013,5,26000,7158,18842,113.649797937149,"05",2013-05-01
"Nebraska","2013-06",2013,6,26000,11867,14133,74.6454696701614,"06",2013-06-01
"Nebraska","2013-07",2013,7,29000,16013,12987,57.703330149068,"07",2013-07-01
"Nebraska","2013-08",2013,8,33000,19865,13135,49.6926132601911,"08",2013-08-01
"Nebraska","2013-09",2013,9,37000,13468,23532,93.2551319648094,"09",2013-09-01
"Nebraska","2014-01",2014,1,29000,15125,13875,62.8895184135977,"01",2014-01-01
"Nebraska","2014-10",2014,10,39000,11805,27195,107.056392087393,"10",2014-10-01
"Nebraska","2014-11",2014,11,37000,11705,25295,103.870239195154,"11",2014-11-01
"Nebraska","2014-12",2014,12,35000,10504,24496,107.665260196906,"12",2014-12-01
"Nebraska","2014-02",2014,2,28000,14081,13919,66.1533708799696,"02",2014-02-01
"Nebraska","2014-03",2014,3,31000,14706,16294,71.2991729751017,"03",2014-03-01
"Nebraska","2014-04",2014,4,33000,16180,16820,68.4017893452623,"04",2014-04-01
"Nebraska","2014-05",2014,5,35000,15107,19893,79.4020795497635,"05",2014-05-01
"Nebraska","2014-06",2014,6,35000,11048,23952,104.030576789437,"06",2014-06-01
"Nebraska","2014-07",2014,7,34000,8662,25338,118.784867094839,"07",2014-07-01
"Nebraska","2014-08",2014,8,36000,9732,26268,114.877984780897,"08",2014-08-01
"Nebraska","2014-09",2014,9,38000,13331,24669,96.1173559837136,"09",2014-09-01
"Nebraska","2015-01",2015,1,34000,11259,22741,100.492719680064,"01",2015-01-01
"Nebraska","2015-10",2015,10,43000,12005,30995,112.698845559495,"10",2015-10-01
"Nebraska","2015-11",2015,11,42000,10150,31850,122.147651006711,"11",2015-11-01
"Nebraska","2015-12",2015,12,40000,9634,30366,122.359672804932,"12",2015-12-01
"Nebraska","2015-02",2015,2,37000,8999,28001,121.746124915759,"02",2015-02-01
"Nebraska","2015-03",2015,3,38000,10066,27934,116.231847875837,"03",2015-03-01
"Nebraska","2015-04",2015,4,39000,11883,27117,106.585696598078,"04",2015-04-01
"Nebraska","2015-05",2015,5,38000,12109,25891,103.33872158694,"05",2015-05-01
"Nebraska","2015-06",2015,6,37000,11358,25642,106.050705157368,"06",2015-06-01
"Nebraska","2015-07",2015,7,37000,12597,24403,98.4051454725084,"07",2015-07-01
"Nebraska","2015-08",2015,8,38000,12850,25150,98.9183874139626,"08",2015-08-01
"Nebraska","2015-09",2015,9,42000,11739,30261,112.62211801485,"09",2015-09-01
"Nebraska","2016-01",2016,1,37000,12054,24946,101.708321441677,"01",2016-01-01
"Nebraska","2016-10",2016,10,43000,19162,23838,76.6963739905408,"10",2016-10-01
"Nebraska","2016-11",2016,11,41000,12452,28548,106.817331437551,"11",2016-11-01
"Nebraska","2016-12",2016,12,40000,10857,29143,114.607625302318,"12",2016-12-01
"Nebraska","2016-02",2016,2,38000,11751,26249,105.521497055336,"02",2016-02-01
"Nebraska","2016-03",2016,3,41000,14888,26112,93.4440309189808,"03",2016-03-01
"Nebraska","2016-04",2016,4,43000,14522,28478,99.0160286499079,"04",2016-04-01
"Nebraska","2016-05",2016,5,44000,14232,29768,102.239318587718,"05",2016-05-01
"Nebraska","2016-06",2016,6,41000,15102,25898,92.3246943067983,"06",2016-06-01
"Nebraska","2016-07",2016,7,42000,16560,25440,86.8852459016393,"07",2016-07-01
"Nebraska","2016-08",2016,8,42000,13906,28094,100.504418130433,"08",2016-08-01
"Nebraska","2016-09",2016,9,43000,18936,24064,77.7060191165074,"09",2016-09-01
"Nebraska","2017-01",2017,1,38000,13112,24888,97.3861324150884,"01",2017-01-01
"Nebraska","2017-10",2017,10,53000,12238,40762,124.963978049603,"10",2017-10-01
"Nebraska","2017-11",2017,11,51000,11448,39552,126.671790930054,"11",2017-11-01
"Nebraska","2017-12",2017,12,47000,9737,37263,131.353437791917,"12",2017-12-01
"Nebraska","2017-02",2017,2,39000,12110,26890,105.224026609274,"02",2017-02-01
"Nebraska","2017-03",2017,3,40000,17237,22763,79.539458741723,"03",2017-03-01
"Nebraska","2017-04",2017,4,43000,14094,28906,101.257575226819,"04",2017-04-01
"Nebraska","2017-05",2017,5,43000,12683,30317,108.89140312124,"05",2017-05-01
"Nebraska","2017-06",2017,6,44000,14274,29726,102.021484710162,"06",2017-06-01
"Nebraska","2017-07",2017,7,43000,14800,28200,97.5778546712803,"07",2017-07-01
"Nebraska","2017-08",2017,8,46000,13078,32922,111.452655810962,"08",2017-08-01
"Nebraska","2017-09",2017,9,50000,11255,38745,126.503958860501,"09",2017-09-01
"Nebraska","2018-01",2018,1,47000,12381,34619,116.599585726074,"01",2018-01-01
"Nebraska","2018-10",2018,10,56000,22864,33136,84.0332724690607,"10",2018-10-01
"Nebraska","2018-11",2018,11,58000,17892,40108,105.697570231381,"11",2018-11-01
"Nebraska","2018-12",2018,12,56000,17105,38895,106.408590383695,"12",2018-12-01
"Nebraska","2018-02",2018,2,48000,13738,34262,110.99160970553,"02",2018-02-01
"Nebraska","2018-03",2018,3,51000,16778,34222,100.982619729116,"03",2018-03-01
"Nebraska","2018-04",2018,4,52000,17183,34817,100.651894251478,"04",2018-04-01
"Nebraska","2018-05",2018,5,54000,22220,31780,83.3901863028077,"05",2018-05-01
"Nebraska","2018-06",2018,6,54000,16505,37495,106.361250975108,"06",2018-06-01
"Nebraska","2018-07",2018,7,55000,22083,32917,85.4066395962793,"07",2018-07-01
"Nebraska","2018-08",2018,8,53000,18846,34154,95.0755783202962,"08",2018-08-01
"Nebraska","2018-09",2018,9,55000,19060,35940,97.0564407237375,"09",2018-09-01
"Nebraska","2019-01",2019,1,55000,14324,40676,117.350412555536,"01",2019-01-01
"Nebraska","2019-10",2019,10,53000,22202,30798,81.9073960798915,"10",2019-10-01
"Nebraska","2019-11",2019,11,53000,23909,29091,75.6504440312577,"11",2019-11-01
"Nebraska","2019-12",2019,12,50000,20616,29384,83.2219327064688,"12",2019-12-01
"Nebraska","2019-02",2019,2,52000,16517,35483,103.574295430331,"02",2019-02-01
"Nebraska","2019-03",2019,3,53000,21986,31014,82.719440962313,"03",2019-03-01
"Nebraska","2019-04",2019,4,51000,18475,32525,93.6308024469234,"04",2019-04-01
"Nebraska","2019-05",2019,5,53000,24283,28717,74.3164732217952,"05",2019-05-01
"Nebraska","2019-06",2019,6,51000,15684,35316,105.920460680223,"06",2019-06-01
"Nebraska","2019-07",2019,7,53000,14871,38129,112.357265989893,"07",2019-07-01
"Nebraska","2019-08",2019,8,52000,16024,35976,105.774432553216,"08",2019-08-01
"Nebraska","2019-09",2019,9,53000,32125,20875,49.0455212922173,"09",2019-09-01
"Nevada","2010-01",2010,1,20000,4127,15873,131.57872922452,"01",2010-01-01
"Nevada","2010-10",2010,10,31000,13044,17956,81.5366451730088,"10",2010-10-01
"Nevada","2010-11",2010,11,34000,11664,22336,97.8276103714086,"11",2010-11-01
"Nevada","2010-12",2010,12,33000,12274,20726,91.5580686486725,"12",2010-12-01
"Nevada","2010-02",2010,2,22000,5082,16918,124.939073923639,"02",2010-02-01
"Nevada","2010-03",2010,3,24000,7600,16400,103.79746835443,"03",2010-03-01
"Nevada","2010-04",2010,4,30000,8199,21801,114.144349328516,"04",2010-04-01
"Nevada","2010-05",2010,5,35000,12870,22130,92.4587424274076,"05",2010-05-01
"Nevada","2010-06",2010,6,37000,9185,27815,120.450362671863,"06",2010-06-01
"Nevada","2010-07",2010,7,33000,11235,21765,98.4062394031875,"07",2010-07-01
"Nevada","2010-08",2010,8,30000,11480,18520,89.2960462873674,"08",2010-08-01
"Nevada","2010-09",2010,9,30000,11443,18557,89.5543276307217,"09",2010-09-01
"Nevada","2011-01",2011,1,32000,10233,21767,103.0805294438,"01",2011-01-01
"Nevada","2011-10",2011,10,35000,11519,23481,100.952299060599,"10",2011-10-01
"Nevada","2011-11",2011,11,33000,8800,24200,115.789473684211,"11",2011-11-01
"Nevada","2011-12",2011,12,31000,9276,21724,107.875657960075,"12",2011-12-01
"Nevada","2011-02",2011,2,30000,9196,20804,106.153689151954,"02",2011-02-01
"Nevada","2011-03",2011,3,31000,13634,17366,77.8151185195143,"03",2011-03-01
"Nevada","2011-04",2011,4,32000,10340,21660,102.314596126594,"04",2011-04-01
"Nevada","2011-05",2011,5,31000,12075,18925,87.8699941961695,"05",2011-05-01
"Nevada","2011-06",2011,6,33000,12530,20470,89.9187349000659,"06",2011-06-01
"Nevada","2011-07",2011,7,33000,14059,18941,80.4989481289445,"07",2011-07-01
"Nevada","2011-08",2011,8,35000,12338,22662,95.7454898812793,"08",2011-08-01
"Nevada","2011-09",2011,9,34000,11102,22898,101.538734424194,"09",2011-09-01
"Nevada","2012-01",2012,1,27000,11807,15193,78.3003066457082,"01",2012-01-01
"Nevada","2012-10",2012,10,36000,13178,22822,92.8138598560332,"10",2012-10-01
"Nevada","2012-11",2012,11,37000,10970,26030,108.526162184699,"11",2012-11-01
"Nevada","2012-12",2012,12,34000,9705,24295,111.177210845441,"12",2012-12-01
"Nevada","2012-02",2012,2,27000,13780,13220,64.835703776361,"02",2012-02-01
"Nevada","2012-03",2012,3,27000,14218,12782,62.021446940657,"03",2012-03-01
"Nevada","2012-04",2012,4,30000,12979,17021,79.2061239209847,"04",2012-04-01
"Nevada","2012-05",2012,5,31000,12035,18965,88.1375624491693,"05",2012-05-01
"Nevada","2012-06",2012,6,31000,11181,19819,93.9712192693393,"06",2012-06-01
"Nevada","2012-07",2012,7,30000,9936,20064,100.480769230769,"07",2012-07-01
"Nevada","2012-08",2012,8,31000,10276,20724,100.416707045256,"08",2012-08-01
"Nevada","2012-09",2012,9,34000,10697,23303,104.270980155268,"09",2012-09-01
"Nevada","2013-01",2013,1,35000,14019,20981,85.6035414839144,"01",2013-01-01
"Nevada","2013-10",2013,10,41000,12430,28570,106.943664607898,"10",2013-10-01
"Nevada","2013-11",2013,11,41000,12458,28542,106.782894982977,"11",2013-11-01
"Nevada","2013-12",2013,12,44000,12857,31143,109.548516453559,"12",2013-12-01
"Nevada","2013-02",2013,2,35000,10550,24450,107.354555433589,"02",2013-02-01
"Nevada","2013-03",2013,3,39000,11866,27134,106.688161050604,"03",2013-03-01
"Nevada","2013-04",2013,4,39000,7954,31046,132.240064744218,"04",2013-04-01
"Nevada","2013-05",2013,5,39000,8019,30981,131.780769476169,"05",2013-05-01
"Nevada","2013-06",2013,6,36000,12010,23990,99.9375130181212,"06",2013-06-01
"Nevada","2013-07",2013,7,33000,14398,18602,78.4927634077387,"07",2013-07-01
"Nevada","2013-08",2013,8,36000,14535,21465,84.9510240427426,"08",2013-08-01
"Nevada","2013-09",2013,9,36000,12491,23509,96.9623229052814,"09",2013-09-01
"Nevada","2014-01",2014,1,45000,14070,30930,104.723209751143,"01",2014-01-01
"Nevada","2014-10",2014,10,53000,12346,40654,124.426896826126,"10",2014-10-01
"Nevada","2014-11",2014,11,50000,11894,38106,123.133098523282,"11",2014-11-01
"Nevada","2014-12",2014,12,45000,10848,34152,122.303394929093,"12",2014-12-01
"Nevada","2014-02",2014,2,49000,13619,35381,113.004040307255,"02",2014-02-01
"Nevada","2014-03",2014,3,52000,17438,34562,99.5477980356577,"03",2014-03-01
"Nevada","2014-04",2014,4,56000,16428,39572,109.272656983487,"04",2014-04-01
"Nevada","2014-05",2014,5,55000,15663,39337,111.336908990561,"05",2014-05-01
"Nevada","2014-06",2014,6,53000,14818,38182,112.601374266419,"06",2014-06-01
"Nevada","2014-07",2014,7,47000,13586,33414,110.302710197075,"07",2014-07-01
"Nevada","2014-08",2014,8,48000,14134,33866,109.009559983262,"08",2014-08-01
"Nevada","2014-09",2014,9,52000,12654,39346,121.712500386674,"09",2014-09-01
"Nevada","2015-01",2015,1,47000,11370,35630,122.083261949632,"01",2015-01-01
"Nevada","2015-10",2015,10,55000,15629,39371,111.486783049456,"10",2015-10-01
"Nevada","2015-11",2015,11,55000,12591,42409,125.487121066414,"11",2015-11-01
"Nevada","2015-12",2015,12,56000,13624,42376,121.728139721935,"12",2015-12-01
"Nevada","2015-02",2015,2,50000,9033,40967,138.793556146562,"02",2015-02-01
"Nevada","2015-03",2015,3,56000,10804,45196,135.309262918388,"03",2015-03-01
"Nevada","2015-04",2015,4,59000,11825,47175,133.215672432051,"04",2015-04-01
"Nevada","2015-05",2015,5,57000,13407,43593,123.83143721505,"05",2015-05-01
"Nevada","2015-06",2015,6,52000,18381,33619,95.5343061337577,"06",2015-06-01
"Nevada","2015-07",2015,7,48000,16312,31688,98.5445950988929,"07",2015-07-01
"Nevada","2015-08",2015,8,50000,16806,33194,99.3743076969135,"08",2015-08-01
"Nevada","2015-09",2015,9,51000,16276,34724,103.228491586896,"09",2015-09-01
"Nevada","2016-01",2016,1,53000,16707,36293,104.130144748734,"01",2016-01-01
"Nevada","2016-10",2016,10,55000,17338,37662,104.127844286544,"10",2016-10-01
"Nevada","2016-11",2016,11,54000,16039,37961,108.399605933837,"11",2016-11-01
"Nevada","2016-12",2016,12,50000,14885,35115,108.237651229098,"12",2016-12-01
"Nevada","2016-02",2016,2,54000,14440,39560,115.604909409702,"02",2016-02-01
"Nevada","2016-03",2016,3,58000,19705,38295,98.5650859018081,"03",2016-03-01
"Nevada","2016-04",2016,4,63000,17199,45801,114.218381775334,"04",2016-04-01
"Nevada","2016-05",2016,5,61000,14881,46119,121.556120768045,"05",2016-05-01
"Nevada","2016-06",2016,6,59000,16969,42031,110.653029525201,"06",2016-06-01
"Nevada","2016-07",2016,7,54000,18229,35771,99.0488584917415,"07",2016-07-01
"Nevada","2016-08",2016,8,54000,16201,37799,107.687924673438,"08",2016-08-01
"Nevada","2016-09",2016,9,55000,18273,36727,100.247021413072,"09",2016-09-01
"Nevada","2017-01",2017,1,50000,15958,34042,103.223263288759,"01",2017-01-01
"Nevada","2017-10",2017,10,67000,14366,52634,129.37590639825,"10",2017-10-01
"Nevada","2017-11",2017,11,63000,13561,49439,129.149305782317,"11",2017-11-01
"Nevada","2017-12",2017,12,61000,10471,50529,141.397210057226,"12",2017-12-01
"Nevada","2017-02",2017,2,53000,18993,34007,94.4730737710611,"02",2017-02-01
"Nevada","2017-03",2017,3,56000,19457,36543,96.8578130590933,"03",2017-03-01
"Nevada","2017-04",2017,4,59000,19081,39919,102.250227328031,"04",2017-04-01
"Nevada","2017-05",2017,5,57000,19613,37387,97.5996240846854,"05",2017-05-01
"Nevada","2017-06",2017,6,55000,19253,35747,96.2843252124493,"06",2017-06-01
"Nevada","2017-07",2017,7,54000,17925,36075,100.312825860271,"07",2017-07-01
"Nevada","2017-08",2017,8,59000,16506,42494,112.557942415172,"08",2017-08-01
"Nevada","2017-09",2017,9,62000,15012,46988,122.027735937257,"09",2017-09-01
"Nevada","2018-01",2018,1,58000,14813,43187,118.6244214632,"01",2018-01-01
"Nevada","2018-10",2018,10,79000,29972,49028,89.9827478618361,"10",2018-10-01
"Nevada","2018-11",2018,11,75000,31993,43007,80.3921751890311,"11",2018-11-01
"Nevada","2018-12",2018,12,73000,26512,46488,93.4319479057802,"12",2018-12-01
"Nevada","2018-02",2018,2,59000,15258,43742,117.810875595895,"02",2018-02-01
"Nevada","2018-03",2018,3,67000,20173,46827,107.434641460085,"03",2018-03-01
"Nevada","2018-04",2018,4,69000,24770,44230,94.33720806228,"04",2018-04-01
"Nevada","2018-05",2018,5,69000,31213,37787,75.4133695229162,"05",2018-05-01
"Nevada","2018-06",2018,6,65000,24284,40716,91.20559114735,"06",2018-06-01
"Nevada","2018-07",2018,7,62000,34737,27263,56.3651963571333,"07",2018-07-01
"Nevada","2018-08",2018,8,68000,29680,38320,78.4602784602785,"08",2018-08-01
"Nevada","2018-09",2018,9,72000,30226,41774,81.7287187212646,"09",2018-09-01
"Nevada","2019-01",2019,1,67000,25642,41358,89.2856371839986,"01",2019-01-01
"Nevada","2019-10",2019,10,65000,34987,30013,60.0338043945713,"10",2019-10-01
"Nevada","2019-11",2019,11,64000,33017,30983,63.871280291083,"11",2019-11-01
"Nevada","2019-12",2019,12,62000,31878,30122,64.1726496090671,"12",2019-12-01
"Nevada","2019-02",2019,2,68000,27657,40343,84.3492896494768,"02",2019-02-01
"Nevada","2019-03",2019,3,70000,33411,36589,70.7642320449469,"03",2019-03-01
"Nevada","2019-04",2019,4,74000,26860,47140,93.4761054927622,"04",2019-04-01
"Nevada","2019-05",2019,5,74000,36025,37975,69.0297659622813,"05",2019-05-01
"Nevada","2019-06",2019,6,70000,27891,42109,86.0324238183286,"06",2019-06-01
"Nevada","2019-07",2019,7,65000,26924,38076,82.8423480266307,"07",2019-07-01
"Nevada","2019-08",2019,8,63000,30694,32306,68.9606591670758,"08",2019-08-01
"Nevada","2019-09",2019,9,63000,36290,26710,53.8019941585255,"09",2019-09-01
"New Hampshire","2010-01",2010,1,14000,2129,11871,147.200694401389,"01",2010-01-01
"New Hampshire","2010-10",2010,10,18000,4992,13008,113.152400835073,"10",2010-10-01
"New Hampshire","2010-11",2010,11,17000,5129,11871,107.289077680871,"11",2010-11-01
"New Hampshire","2010-12",2010,12,16000,4741,11259,108.567571476785,"12",2010-12-01
"New Hampshire","2010-02",2010,2,15000,4744,10256,103.889789303079,"02",2010-02-01
"New Hampshire","2010-03",2010,3,15000,4552,10448,106.873977086743,"03",2010-03-01
"New Hampshire","2010-04",2010,4,17000,3817,13183,126.656098381131,"04",2010-04-01
"New Hampshire","2010-05",2010,5,18000,4666,13334,117.656401658872,"05",2010-05-01
"New Hampshire","2010-06",2010,6,19000,6282,12718,100.609129024602,"06",2010-06-01
"New Hampshire","2010-07",2010,7,18000,4919,13081,114.149832017104,"07",2010-07-01
"New Hampshire","2010-08",2010,8,19000,5357,13643,112.025290470912,"08",2010-08-01
"New Hampshire","2010-09",2010,9,18000,5700,12300,103.79746835443,"09",2010-09-01
"New Hampshire","2011-01",2011,1,17000,4203,12797,120.70933358487,"01",2011-01-01
"New Hampshire","2011-10",2011,10,18000,4408,13592,121.313816494109,"10",2011-10-01
"New Hampshire","2011-11",2011,11,18000,3416,14584,136.197235711617,"11",2011-11-01
"New Hampshire","2011-12",2011,12,17000,4945,12055,109.865573023468,"12",2011-12-01
"New Hampshire","2011-02",2011,2,17000,5348,11652,104.277787721496,"02",2011-02-01
"New Hampshire","2011-03",2011,3,17000,6116,10884,94.1685412701159,"03",2011-03-01
"New Hampshire","2011-04",2011,4,16000,4786,11214,107.899547772539,"04",2011-04-01
"New Hampshire","2011-05",2011,5,17000,5458,11542,102.787425416333,"05",2011-05-01
"New Hampshire","2011-06",2011,6,17000,5333,11667,104.482156450096,"06",2011-06-01
"New Hampshire","2011-07",2011,7,18000,5229,12771,109.957380860132,"07",2011-07-01
"New Hampshire","2011-08",2011,8,19000,4786,14214,119.515681493315,"08",2011-08-01
"New Hampshire","2011-09",2011,9,19000,4522,14478,123.101777059774,"09",2011-09-01
"New Hampshire","2012-01",2012,1,18000,4881,13119,114.671561557624,"01",2012-01-01
"New Hampshire","2012-10",2012,10,22000,4459,17541,132.590044975245,"10",2012-10-01
"New Hampshire","2012-11",2012,11,19000,3797,15203,133.377198754222,"11",2012-11-01
"New Hampshire","2012-12",2012,12,19000,4642,14358,121.461805261822,"12",2012-12-01
"New Hampshire","2012-02",2012,2,17000,7045,9955,82.8030775629029,"02",2012-02-01
"New Hampshire","2012-03",2012,3,19000,6020,12980,103.756994404476,"03",2012-03-01
"New Hampshire","2012-04",2012,4,19000,5499,13501,110.216743540553,"04",2012-04-01
"New Hampshire","2012-05",2012,5,21000,5060,15940,122.333077513431,"05",2012-05-01
"New Hampshire","2012-06",2012,6,21000,4237,16763,132.844632880295,"06",2012-06-01
"New Hampshire","2012-07",2012,7,21000,4003,16997,135.959684837819,"07",2012-07-01
"New Hampshire","2012-08",2012,8,23000,3804,19196,143.232353380093,"08",2012-08-01
"New Hampshire","2012-09",2012,9,22000,3755,18245,141.681226946224,"09",2012-09-01
"New Hampshire","2013-01",2013,1,19000,8247,10753,78.9297904356443,"01",2013-01-01
"New Hampshire","2013-10",2013,10,21000,6488,14512,105.587892898719,"10",2013-10-01
"New Hampshire","2013-11",2013,11,20000,6210,13790,105.227012590614,"11",2013-11-01
"New Hampshire","2013-12",2013,12,21000,8578,12422,83.9948610453716,"12",2013-12-01
"New Hampshire","2013-02",2013,2,18000,5890,12110,101.381331100879,"02",2013-02-01
"New Hampshire","2013-03",2013,3,19000,4880,14120,118.257956448911,"03",2013-03-01
"New Hampshire","2013-04",2013,4,19000,4546,14454,122.772445425975,"04",2013-04-01
"New Hampshire","2013-05",2013,5,20000,4449,15551,127.211746901714,"05",2013-05-01
"New Hampshire","2013-06",2013,6,22000,6971,15029,103.752027889959,"06",2013-06-01
"New Hampshire","2013-07",2013,7,21000,9199,11801,78.1549057915825,"07",2013-07-01
"New Hampshire","2013-08",2013,8,22000,8248,13752,90.9283258397249,"08",2013-08-01
"New Hampshire","2013-09",2013,9,20000,6791,13209,98.6077414056959,"09",2013-09-01
"New Hampshire","2014-01",2014,1,20000,9767,10233,68.7539893170289,"01",2014-01-01
"New Hampshire","2014-10",2014,10,25000,6921,18079,113.273393690674,"10",2014-10-01
"New Hampshire","2014-11",2014,11,23000,5683,17317,120.747481086358,"11",2014-11-01
"New Hampshire","2014-12",2014,12,22000,5288,16712,122.486074464966,"12",2014-12-01
"New Hampshire","2014-02",2014,2,19000,8384,10616,77.5343266140812,"02",2014-02-01
"New Hampshire","2014-03",2014,3,18000,9968,8032,57.4370709382151,"03",2014-03-01
"New Hampshire","2014-04",2014,4,20000,10355,9645,63.5480151540109,"04",2014-04-01
"New Hampshire","2014-05",2014,5,21000,9878,11122,72.0383444523609,"05",2014-05-01
"New Hampshire","2014-06",2014,6,23000,9285,13715,84.96205668267,"06",2014-06-01
"New Hampshire","2014-07",2014,7,25000,6565,18435,116.806589577063,"07",2014-07-01
"New Hampshire","2014-08",2014,8,26000,7671,18329,108.871135398414,"08",2014-08-01
"New Hampshire","2014-09",2014,9,27000,6666,20334,120.798431652112,"09",2014-09-01
"New Hampshire","2015-01",2015,1,23000,5783,17217,119.633116770316,"01",2015-01-01
"New Hampshire","2015-10",2015,10,27000,8089,18911,107.788765710052,"10",2015-10-01
"New Hampshire","2015-11",2015,11,26000,7196,18804,113.290757922641,"11",2015-11-01
"New Hampshire","2015-12",2015,12,27000,6553,20447,121.878818585521,"12",2015-12-01
"New Hampshire","2015-02",2015,2,24000,4662,19338,134.938245760938,"02",2015-02-01
"New Hampshire","2015-03",2015,3,24000,6348,17652,116.330565440886,"03",2015-03-01
"New Hampshire","2015-04",2015,4,24000,6475,17525,115.012305168171,"04",2015-04-01
"New Hampshire","2015-05",2015,5,24000,7139,16861,108.295064067568,"05",2015-05-01
"New Hampshire","2015-06",2015,6,24000,6996,17004,109.717382888115,"06",2015-06-01
"New Hampshire","2015-07",2015,7,26000,8433,17567,102.035837713821,"07",2015-07-01
"New Hampshire","2015-08",2015,8,27000,7936,19064,109.136707121594,"08",2015-08-01
"New Hampshire","2015-09",2015,9,27000,6925,20075,118.349299926308,"09",2015-09-01
"New Hampshire","2016-01",2016,1,27000,10078,16922,91.2778467015481,"01",2016-01-01
"New Hampshire","2016-10",2016,10,27000,11018,15982,84.0759640170446,"10",2016-10-01
"New Hampshire","2016-11",2016,11,26000,8835,17165,98.5503085976748,"11",2016-11-01
"New Hampshire","2016-12",2016,12,26000,9414,16586,93.6691703845937,"12",2016-12-01
"New Hampshire","2016-02",2016,2,26000,8112,17888,104.878048780488,"02",2016-02-01
"New Hampshire","2016-03",2016,3,25000,9931,15069,86.2786636511981,"03",2016-03-01
"New Hampshire","2016-04",2016,4,24000,9165,14835,89.4617819990954,"04",2016-04-01
"New Hampshire","2016-05",2016,5,25000,7992,17008,103.103782735209,"05",2016-05-01
"New Hampshire","2016-06",2016,6,27000,8792,18208,101.743406347787,"06",2016-06-01
"New Hampshire","2016-07",2016,7,28000,9065,18935,102.171860245515,"07",2016-07-01
"New Hampshire","2016-08",2016,8,29000,9042,19958,104.926134272646,"08",2016-08-01
"New Hampshire","2016-09",2016,9,29000,10860,18140,91.018564977421,"09",2016-09-01
"New Hampshire","2017-01",2017,1,26000,9191,16809,95.5301071296638,"01",2017-01-01
"New Hampshire","2017-10",2017,10,29000,8889,20111,106.157459948798,"10",2017-10-01
"New Hampshire","2017-11",2017,11,28000,8457,19543,107.211235153743,"11",2017-11-01
"New Hampshire","2017-12",2017,12,30000,6866,23134,125.503173655943,"12",2017-12-01
"New Hampshire","2017-02",2017,2,26000,10626,15374,83.9512914323158,"02",2017-02-01
"New Hampshire","2017-03",2017,3,25000,11757,13243,72.0570231520527,"03",2017-03-01
"New Hampshire","2017-04",2017,4,28000,11505,16495,83.5084166561195,"04",2017-04-01
"New Hampshire","2017-05",2017,5,29000,10500,18500,93.6708860759494,"05",2017-05-01
"New Hampshire","2017-06",2017,6,30000,10267,19733,98.010778056473,"06",2017-06-01
"New Hampshire","2017-07",2017,7,29000,10176,18824,96.0996528486829,"07",2017-07-01
"New Hampshire","2017-08",2017,8,30000,8949,21051,108.095201417238,"08",2017-08-01
"New Hampshire","2017-09",2017,9,29000,8907,20093,106.012082201177,"09",2017-09-01
"New Hampshire","2018-01",2018,1,31000,9054,21946,109.582064213312,"01",2018-01-01
"New Hampshire","2018-10",2018,10,33000,8957,24043,114.607812760684,"10",2018-10-01
"New Hampshire","2018-11",2018,11,32000,7456,24544,124.41200324412,"11",2018-11-01
"New Hampshire","2018-12",2018,12,33000,7860,25140,123.054331864905,"12",2018-12-01
"New Hampshire","2018-02",2018,2,30000,9386,20614,104.676788706647,"02",2018-02-01
"New Hampshire","2018-03",2018,3,31000,11603,19397,91.0593150717086,"03",2018-03-01
"New Hampshire","2018-04",2018,4,33000,11667,21333,95.5201826852038,"04",2018-04-01
"New Hampshire","2018-05",2018,5,35000,11570,23430,100.622718488297,"05",2018-05-01
"New Hampshire","2018-06",2018,6,36000,7881,28119,128.160251589526,"06",2018-06-01
"New Hampshire","2018-07",2018,7,35000,10418,24582,108.24783125633,"07",2018-07-01
"New Hampshire","2018-08",2018,8,35000,9811,25189,112.423288924594,"08",2018-08-01
"New Hampshire","2018-09",2018,9,33000,8938,24062,114.750345748486,"09",2018-09-01
"New Hampshire","2019-01",2019,1,34000,7845,26155,125.008961644163,"01",2019-01-01
"New Hampshire","2019-10",2019,10,35000,11436,23564,101.490223102765,"10",2019-10-01
"New Hampshire","2019-11",2019,11,31000,11154,19846,94.1595103667505,"11",2019-11-01
"New Hampshire","2019-12",2019,12,31000,11053,19947,94.8660024255107,"12",2019-12-01
"New Hampshire","2019-02",2019,2,34000,6531,27469,135.545631738669,"02",2019-02-01
"New Hampshire","2019-03",2019,3,34000,10368,23632,106.527226830148,"03",2019-03-01
"New Hampshire","2019-04",2019,4,33000,9091,23909,113.606234111805,"04",2019-04-01
"New Hampshire","2019-05",2019,5,34000,9757,24243,110.807413670955,"05",2019-05-01
"New Hampshire","2019-06",2019,6,36000,7672,28328,129.730719912072,"06",2019-06-01
"New Hampshire","2019-07",2019,7,36000,6815,29185,136.330725213126,"07",2019-07-01
"New Hampshire","2019-08",2019,8,38000,9699,28301,118.664961529592,"08",2019-08-01
"New Hampshire","2019-09",2019,9,36000,14513,21487,85.0751291746679,"09",2019-09-01
"New Jersey","2010-01",2010,1,70000,15021,54979,129.330400724527,"01",2010-01-01
"New Jersey","2010-10",2010,10,106000,50860,55140,70.3047303327808,"10",2010-10-01
"New Jersey","2010-11",2010,11,98000,38458,59542,87.2678772955781,"11",2010-11-01
"New Jersey","2010-12",2010,12,94000,37019,56981,86.9812775246338,"12",2010-12-01
"New Jersey","2010-02",2010,2,78000,34860,43140,76.4486975013291,"02",2010-02-01
"New Jersey","2010-03",2010,3,88000,34695,53305,86.8902563266637,"03",2010-03-01
"New Jersey","2010-04",2010,4,101000,42321,58679,81.8847203131432,"04",2010-04-01
"New Jersey","2010-05",2010,5,106000,42667,63333,85.2011542575017,"05",2010-05-01
"New Jersey","2010-06",2010,6,104000,36986,67014,95.0647582029421,"06",2010-06-01
"New Jersey","2010-07",2010,7,104000,34876,69124,99.5477980356577,"07",2010-07-01
"New Jersey","2010-08",2010,8,107000,44564,62436,82.3889578000053,"08",2010-08-01
"New Jersey","2010-09",2010,9,107000,39031,67969,93.0884538214489,"09",2010-09-01
"New Jersey","2011-01",2011,1,88000,35871,52129,84.1665926649498,"01",2011-01-01
"New Jersey","2011-10",2011,10,95000,42405,52595,76.5547105272734,"10",2011-10-01
"New Jersey","2011-11",2011,11,94000,29961,64039,103.321205863134,"11",2011-11-01
"New Jersey","2011-12",2011,12,87000,32522,54478,91.1597864828233,"12",2011-12-01
"New Jersey","2011-02",2011,2,89000,35574,53426,85.7739175108771,"02",2011-02-01
"New Jersey","2011-03",2011,3,96000,46363,49637,69.7330064693776,"03",2011-03-01
"New Jersey","2011-04",2011,4,95000,38364,56636,84.9344650730332,"04",2011-04-01
"New Jersey","2011-05",2011,5,94000,36036,57964,89.1506967301363,"05",2011-05-01
"New Jersey","2011-06",2011,6,89000,33794,55206,89.9164454289297,"06",2011-06-01
"New Jersey","2011-07",2011,7,91000,47169,43831,63.4454906672264,"07",2011-07-01
"New Jersey","2011-08",2011,8,92000,38150,53850,82.7506723011909,"08",2011-08-01
"New Jersey","2011-09",2011,9,93000,35464,57536,89.5752895752896,"09",2011-09-01
"New Jersey","2012-01",2012,1,79000,42931,36069,59.1629692202967,"01",2012-01-01
"New Jersey","2012-10",2012,10,97000,39444,57556,84.3657471196975,"10",2012-10-01
"New Jersey","2012-11",2012,11,92000,30655,61345,100.028535322653,"11",2012-11-01
"New Jersey","2012-12",2012,12,92000,35364,56636,88.9356490059986,"12",2012-12-01
"New Jersey","2012-02",2012,2,78000,41797,36203,60.440578645542,"02",2012-02-01
"New Jersey","2012-03",2012,3,84000,45567,38433,59.3252911621015,"03",2012-03-01
"New Jersey","2012-04",2012,4,102000,37819,64181,91.805834686273,"04",2012-04-01
"New Jersey","2012-05",2012,5,105000,45152,59848,79.7165538920561,"05",2012-05-01
"New Jersey","2012-06",2012,6,106000,39068,66932,92.2767253977445,"06",2012-06-01
"New Jersey","2012-07",2012,7,99000,37941,61059,89.175630380967,"07",2012-07-01
"New Jersey","2012-08",2012,8,1e+05,35319,64681,95.5978096202307,"08",2012-08-01
"New Jersey","2012-09",2012,9,96000,37698,58302,87.2144684288471,"09",2012-09-01
"New Jersey","2013-01",2013,1,85000,45141,39859,61.2551002374348,"01",2013-01-01
"New Jersey","2013-10",2013,10,122000,41101,80899,99.2011085155824,"10",2013-10-01
"New Jersey","2013-11",2013,11,122000,44308,77692,93.431464511629,"11",2013-11-01
"New Jersey","2013-12",2013,12,109000,42962,66038,86.9138337215883,"12",2013-12-01
"New Jersey","2013-02",2013,2,88000,39032,48968,77.0955349833113,"02",2013-02-01
"New Jersey","2013-03",2013,3,95000,40830,54170,79.7614665390562,"03",2013-03-01
"New Jersey","2013-04",2013,4,104000,34688,69312,99.9538532533456,"04",2013-04-01
"New Jersey","2013-05",2013,5,111000,36499,74501,101.018989959254,"05",2013-05-01
"New Jersey","2013-06",2013,6,120000,41688,78312,96.868042155262,"06",2013-06-01
"New Jersey","2013-07",2013,7,125000,68415,56585,58.5114908357677,"07",2013-07-01
"New Jersey","2013-08",2013,8,126000,48069,77931,89.5403546869345,"08",2013-08-01
"New Jersey","2013-09",2013,9,123000,44013,78987,94.5878464550664,"09",2013-09-01
"New Jersey","2014-01",2014,1,99000,41351,57649,82.149753118966,"01",2014-01-01
"New Jersey","2014-10",2014,10,132000,43891,88109,100.185910592355,"10",2014-10-01
"New Jersey","2014-11",2014,11,124000,37740,86260,106.665017930011,"11",2014-11-01
"New Jersey","2014-12",2014,12,108000,40314,67686,91.2739188478498,"12",2014-12-01
"New Jersey","2014-02",2014,2,103000,39944,63056,88.2247593463174,"02",2014-02-01
"New Jersey","2014-03",2014,3,114000,49883,64117,78.2472861736727,"03",2014-03-01
"New Jersey","2014-04",2014,4,122000,50949,71051,82.1641061815911,"04",2014-04-01
"New Jersey","2014-05",2014,5,125000,56400,68600,75.6339581036384,"05",2014-05-01
"New Jersey","2014-06",2014,6,132000,48704,83296,92.1905436514964,"06",2014-06-01
"New Jersey","2014-07",2014,7,127000,40819,86181,102.707083226571,"07",2014-07-01
"New Jersey","2014-08",2014,8,129000,45007,83993,96.5397943760883,"08",2014-08-01
"New Jersey","2014-09",2014,9,128000,46181,81819,93.9471010041279,"09",2014-09-01
"New Jersey","2015-01",2015,1,1e+05,39690,60310,86.3483427589663,"01",2015-01-01
"New Jersey","2015-10",2015,10,132000,55945,76055,80.9332517491819,"10",2015-10-01
"New Jersey","2015-11",2015,11,128000,49730,78270,88.0774208068418,"11",2015-11-01
"New Jersey","2015-12",2015,12,130000,41716,88284,102.825595751124,"12",2015-12-01
"New Jersey","2015-02",2015,2,113000,33978,79022,107.529017948264,"02",2015-02-01
"New Jersey","2015-03",2015,3,124000,42458,81542,97.973062273967,"03",2015-03-01
"New Jersey","2015-04",2015,4,139000,48208,90792,96.9958548779967,"04",2015-04-01
"New Jersey","2015-05",2015,5,136000,47804,88196,95.9674435812061,"05",2015-05-01
"New Jersey","2015-06",2015,6,133000,45450,87550,98.1227234519473,"06",2015-06-01
"New Jersey","2015-07",2015,7,132000,58408,73592,77.299273139784,"07",2015-07-01
"New Jersey","2015-08",2015,8,125000,55398,69602,77.1649353097041,"08",2015-08-01
"New Jersey","2015-09",2015,9,128000,52312,75688,83.952260526199,"09",2015-09-01
"New Jersey","2016-01",2016,1,126000,53376,72624,80.974043350281,"01",2016-01-01
"New Jersey","2016-10",2016,10,158000,57356,100644,93.467560690206,"10",2016-10-01
"New Jersey","2016-11",2016,11,156000,51868,104132,100.190505513114,"11",2016-11-01
"New Jersey","2016-12",2016,12,140000,45930,94070,101.188619372882,"12",2016-12-01
"New Jersey","2016-02",2016,2,137000,48453,88547,95.4926585172524,"02",2016-02-01
"New Jersey","2016-03",2016,3,144000,61452,82548,80.357455756089,"03",2016-03-01
"New Jersey","2016-04",2016,4,144000,53416,90584,91.7696640596507,"04",2016-04-01
"New Jersey","2016-05",2016,5,147000,51654,95346,95.9920263372497,"05",2016-05-01
"New Jersey","2016-06",2016,6,141000,56939,84061,84.9362682442571,"06",2016-06-01
"New Jersey","2016-07",2016,7,147000,56099,90901,89.513980866474,"07",2016-07-01
"New Jersey","2016-08",2016,8,147000,50040,96960,98.4165651644336,"08",2016-08-01
"New Jersey","2016-09",2016,9,161000,60873,100127,90.2561375201129,"09",2016-09-01
"New Jersey","2017-01",2017,1,131000,51963,79037,86.3967031585621,"01",2017-01-01
"New Jersey","2017-10",2017,10,174000,51497,122503,108.651556339996,"10",2017-10-01
"New Jersey","2017-11",2017,11,167000,46298,120702,113.17686991908,"11",2017-11-01
"New Jersey","2017-12",2017,12,166000,39635,126365,122.9022296788,"12",2017-12-01
"New Jersey","2017-02",2017,2,130000,54466,75534,81.8947665152386,"02",2017-02-01
"New Jersey","2017-03",2017,3,137000,64512,72488,71.9441025844615,"03",2017-03-01
"New Jersey","2017-04",2017,4,145000,62964,82036,78.8944240349291,"04",2017-04-01
"New Jersey","2017-05",2017,5,153000,62893,90107,83.4737578337417,"05",2017-05-01
"New Jersey","2017-06",2017,6,157000,60602,96398,88.6002886002886,"06",2017-06-01
"New Jersey","2017-07",2017,7,165000,63506,101494,88.8326783541789,"07",2017-07-01
"New Jersey","2017-08",2017,8,168000,61153,106847,93.253852229733,"08",2017-08-01
"New Jersey","2017-09",2017,9,175000,55444,119556,103.761434448282,"09",2017-09-01
"New Jersey","2018-01",2018,1,164000,52480,111520,103.030303030303,"01",2018-01-01
"New Jersey","2018-10",2018,10,212000,65418,146582,105.675911440498,"10",2018-10-01
"New Jersey","2018-11",2018,11,208000,59003,148997,111.606985689299,"11",2018-11-01
"New Jersey","2018-12",2018,12,187000,57391,129609,106.066917357841,"12",2018-12-01
"New Jersey","2018-02",2018,2,162000,52116,109884,102.639690634983,"02",2018-02-01
"New Jersey","2018-03",2018,3,162000,61931,100069,89.3748520749695,"03",2018-03-01
"New Jersey","2018-04",2018,4,174000,58884,115116,98.8612356366259,"04",2018-04-01
"New Jersey","2018-05",2018,5,190000,87701,102299,73.6756439479872,"05",2018-05-01
"New Jersey","2018-06",2018,6,196000,55581,140419,111.629256581379,"06",2018-06-01
"New Jersey","2018-07",2018,7,197000,79630,117370,84.8570292448397,"07",2018-07-01
"New Jersey","2018-08",2018,8,199000,69795,129205,96.136460871668,"08",2018-08-01
"New Jersey","2018-09",2018,9,214000,69363,144637,102.08601687588,"09",2018-09-01
"New Jersey","2019-01",2019,1,182000,62090,119910,98.2506452537998,"01",2019-01-01
"New Jersey","2019-10",2019,10,199000,83725,115275,81.5456715889999,"10",2019-10-01
"New Jersey","2019-11",2019,11,197000,80327,116673,84.1411041838696,"11",2019-11-01
"New Jersey","2019-12",2019,12,182000,73440,108560,84.9984340745381,"12",2019-12-01
"New Jersey","2019-02",2019,2,173000,54164,118836,104.625732950644,"02",2019-02-01
"New Jersey","2019-03",2019,3,175000,68948,106052,86.9463984127765,"03",2019-03-01
"New Jersey","2019-04",2019,4,172000,59326,112674,97.4157682232002,"04",2019-04-01
"New Jersey","2019-05",2019,5,182000,65889,116111,93.6798325056779,"05",2019-05-01
"New Jersey","2019-06",2019,6,180000,57553,122447,103.090257753007,"06",2019-06-01
"New Jersey","2019-07",2019,7,183000,49998,133002,114.165786830788,"07",2019-07-01
"New Jersey","2019-08",2019,8,186000,78634,107366,81.1430126136475,"08",2019-08-01
"New Jersey","2019-09",2019,9,194000,104088,89912,60.3258098279703,"09",2019-09-01
"New Mexico","2010-01",2010,1,17000,1629,15371,165.022277094852,"01",2010-01-01
"New Mexico","2010-10",2010,10,23000,7633,15367,100.329709790096,"10",2010-10-01
"New Mexico","2010-11",2010,11,22000,7620,14380,97.0965563808238,"11",2010-11-01
"New Mexico","2010-12",2010,12,21000,7221,13779,97.6506856596152,"12",2010-12-01
"New Mexico","2010-02",2010,2,18000,4538,13462,119.460466767238,"02",2010-02-01
"New Mexico","2010-03",2010,3,20000,3831,16169,135.697201124586,"03",2010-03-01
"New Mexico","2010-04",2010,4,22000,6024,15976,114.016557236654,"04",2010-04-01
"New Mexico","2010-05",2010,5,23000,6497,16503,111.896125029664,"05",2010-05-01
"New Mexico","2010-06",2010,6,23000,5634,17366,121.296360969477,"06",2010-06-01
"New Mexico","2010-07",2010,7,19000,7602,11398,85.6928050522517,"07",2010-07-01
"New Mexico","2010-08",2010,8,21000,6934,14066,100.708813632133,"08",2010-08-01
"New Mexico","2010-09",2010,9,22000,6365,15635,110.241494799929,"09",2010-09-01
"New Mexico","2011-01",2011,1,19000,6974,12026,92.6002926002926,"01",2011-01-01
"New Mexico","2011-10",2011,10,25000,10178,14822,84.2685769515038,"10",2011-10-01
"New Mexico","2011-11",2011,11,23000,8922,14078,88.2024935780966,"11",2011-11-01
"New Mexico","2011-12",2011,12,21000,7480,13520,94.9438202247191,"12",2011-12-01
"New Mexico","2011-02",2011,2,19000,5587,13413,109.106438361736,"02",2011-02-01
"New Mexico","2011-03",2011,3,22000,9846,12154,76.3298373422094,"03",2011-03-01
"New Mexico","2011-04",2011,4,24000,8693,15307,93.6408405469061,"04",2011-04-01
"New Mexico","2011-05",2011,5,24000,10158,13842,81.0468997013877,"05",2011-05-01
"New Mexico","2011-06",2011,6,24000,10657,13343,77.000317396197,"06",2011-06-01
"New Mexico","2011-07",2011,7,25000,11207,13793,76.1896870770845,"07",2011-07-01
"New Mexico","2011-08",2011,8,26000,10786,15214,82.716250747567,"08",2011-08-01
"New Mexico","2011-09",2011,9,26000,9121,16879,96.1191310042425,"09",2011-09-01
"New Mexico","2012-01",2012,1,22000,7875,14125,94.5606694560669,"01",2012-01-01
"New Mexico","2012-10",2012,10,27000,7115,19885,116.576286091162,"10",2012-10-01
"New Mexico","2012-11",2012,11,26000,5771,20229,127.342545088288,"11",2012-11-01
"New Mexico","2012-12",2012,12,25000,6101,18899,121.533069676216,"12",2012-12-01
"New Mexico","2012-02",2012,2,24000,8538,15462,95.0396459524249,"02",2012-02-01
"New Mexico","2012-03",2012,3,26000,9309,16691,94.5424679260245,"03",2012-03-01
"New Mexico","2012-04",2012,4,26000,8726,17274,99.4874157691643,"04",2012-04-01
"New Mexico","2012-05",2012,5,28000,9260,18740,100.590445517982,"05",2012-05-01
"New Mexico","2012-06",2012,6,30000,8087,21913,115.068133483866,"06",2012-06-01
"New Mexico","2012-07",2012,7,29000,7187,21813,120.55710614309,"07",2012-07-01
"New Mexico","2012-08",2012,8,28000,6886,21114,121.045691681477,"08",2012-08-01
"New Mexico","2012-09",2012,9,26000,6937,19063,115.75431885114,"09",2012-09-01
"New Mexico","2013-01",2013,1,25000,8935,16065,94.6810078090467,"01",2013-01-01
"New Mexico","2013-10",2013,10,28000,10260,17740,92.7339257710402,"10",2013-10-01
"New Mexico","2013-11",2013,11,26000,8493,17507,101.510451395935,"11",2013-11-01
"New Mexico","2013-12",2013,12,24000,9255,14745,88.6783942264321,"12",2013-12-01
"New Mexico","2013-02",2013,2,25000,7014,17986,112.363341038296,"02",2013-02-01
"New Mexico","2013-03",2013,3,26000,8185,17815,104.227000146263,"03",2013-03-01
"New Mexico","2013-04",2013,4,28000,6491,21509,124.722391348468,"04",2013-04-01
"New Mexico","2013-05",2013,5,28000,5628,22372,133.055786844296,"05",2013-05-01
"New Mexico","2013-06",2013,6,28000,8872,19128,103.753525710566,"06",2013-06-01
"New Mexico","2013-07",2013,7,25000,12533,12467,66.4322063251006,"07",2013-07-01
"New Mexico","2013-08",2013,8,27000,15188,11812,55.9969659618849,"08",2013-08-01
"New Mexico","2013-09",2013,9,27000,14285,12715,61.5962213879133,"09",2013-09-01
"New Mexico","2014-01",2014,1,24000,11377,12623,71.3627498091981,"01",2014-01-01
"New Mexico","2014-10",2014,10,37000,10560,26440,111.185870479394,"10",2014-10-01
"New Mexico","2014-11",2014,11,33000,8133,24867,120.91021807308,"11",2014-11-01
"New Mexico","2014-12",2014,12,32000,7441,24559,124.535381962932,"12",2014-12-01
"New Mexico","2014-02",2014,2,25000,10302,14698,83.2700696844371,"02",2014-02-01
"New Mexico","2014-03",2014,3,27000,10845,16155,85.3745541022592,"03",2014-03-01
"New Mexico","2014-04",2014,4,28000,10927,17073,87.7180363244021,"04",2014-04-01
"New Mexico","2014-05",2014,5,31000,12174,18826,87.2098948441191,"05",2014-05-01
"New Mexico","2014-06",2014,6,33000,11559,21441,96.2364505487107,"06",2014-06-01
"New Mexico","2014-07",2014,7,34000,9993,24007,109.140090468938,"07",2014-07-01
"New Mexico","2014-08",2014,8,36000,10437,25563,110.097551521416,"08",2014-08-01
"New Mexico","2014-09",2014,9,36000,11396,24604,103.823107435227,"09",2014-09-01
"New Mexico","2015-01",2015,1,32000,11017,20983,97.5567798777228,"01",2015-01-01
"New Mexico","2015-10",2015,10,38000,10721,27279,111.980460171179,"10",2015-10-01
"New Mexico","2015-11",2015,11,35000,8957,26043,118.493072775667,"11",2015-11-01
"New Mexico","2015-12",2015,12,35000,9784,25216,112.611647016792,"12",2015-12-01
"New Mexico","2015-02",2015,2,32000,6392,25608,133.402792248385,"02",2015-02-01
"New Mexico","2015-03",2015,3,32000,7201,24799,126.522282594832,"03",2015-03-01
"New Mexico","2015-04",2015,4,32000,7843,24157,121.260949225711,"04",2015-04-01
"New Mexico","2015-05",2015,5,32000,9522,22478,108.270314532055,"05",2015-05-01
"New Mexico","2015-06",2015,6,33000,8726,24274,116.349518285961,"06",2015-06-01
"New Mexico","2015-07",2015,7,36000,9959,26041,113.322744185034,"07",2015-07-01
"New Mexico","2015-08",2015,8,38000,11110,26890,109.509264915496,"08",2015-08-01
"New Mexico","2015-09",2015,9,38000,9773,28227,118.171352018923,"09",2015-09-01
"New Mexico","2016-01",2016,1,31000,10186,20814,101.073180206866,"01",2016-01-01
"New Mexico","2016-10",2016,10,38000,12317,25683,102.084782479083,"10",2016-10-01
"New Mexico","2016-11",2016,11,35000,9101,25899,117.453118976894,"11",2016-11-01
"New Mexico","2016-12",2016,12,33000,9487,23513,110.683267823099,"12",2016-12-01
"New Mexico","2016-02",2016,2,33000,9461,23539,110.873507453899,"02",2016-02-01
"New Mexico","2016-03",2016,3,34000,11806,22194,96.9043356765489,"03",2016-03-01
"New Mexico","2016-04",2016,4,36000,10121,25879,112.222198131003,"04",2016-04-01
"New Mexico","2016-05",2016,5,37000,9356,27644,119.268271636897,"05",2016-05-01
"New Mexico","2016-06",2016,6,38000,10606,27394,112.718594412212,"06",2016-06-01
"New Mexico","2016-07",2016,7,39000,10902,28098,112.612720933029,"07",2016-07-01
"New Mexico","2016-08",2016,8,41000,10405,30595,119.035113315825,"08",2016-08-01
"New Mexico","2016-09",2016,9,41000,11592,29408,111.834499543657,"09",2016-09-01
"New Mexico","2017-01",2017,1,32000,9643,22357,107.374588766419,"01",2017-01-01
"New Mexico","2017-10",2017,10,38000,9417,28583,120.560136659848,"10",2017-10-01
"New Mexico","2017-11",2017,11,33000,9002,23998,114.270749011952,"11",2017-11-01
"New Mexico","2017-12",2017,12,32000,7040,24960,127.868852459016,"12",2017-12-01
"New Mexico","2017-02",2017,2,33000,10825,22175,101.197946377638,"02",2017-02-01
"New Mexico","2017-03",2017,3,33000,13221,19779,85.5844745894723,"03",2017-03-01
"New Mexico","2017-04",2017,4,36000,10078,25922,112.513563956769,"04",2017-04-01
"New Mexico","2017-05",2017,5,35000,10879,24121,105.150504588156,"05",2017-05-01
"New Mexico","2017-06",2017,6,37000,10519,26481,111.454365622172,"06",2017-06-01
"New Mexico","2017-07",2017,7,36000,11360,24640,104.054054054054,"07",2017-07-01
"New Mexico","2017-08",2017,8,40000,9868,30132,120.847036175503,"08",2017-08-01
"New Mexico","2017-09",2017,9,39000,9672,29328,120.512820512821,"09",2017-09-01
"New Mexico","2018-01",2018,1,34000,9581,24419,112.06259608545,"01",2018-01-01
"New Mexico","2018-10",2018,10,48000,15066,32934,104.442964513367,"10",2018-10-01
"New Mexico","2018-11",2018,11,43000,14764,28236,97.763312789973,"11",2018-11-01
"New Mexico","2018-12",2018,12,44000,13362,30638,106.823332519787,"12",2018-12-01
"New Mexico","2018-02",2018,2,39000,11399,27601,109.529950991091,"02",2018-02-01
"New Mexico","2018-03",2018,3,41000,12988,28012,103.771208416685,"03",2018-03-01
"New Mexico","2018-04",2018,4,43000,13084,29916,106.682832893517,"04",2018-04-01
"New Mexico","2018-05",2018,5,41000,17445,23555,80.6056976644709,"05",2018-05-01
"New Mexico","2018-06",2018,6,44000,12520,31480,111.394196744515,"06",2018-06-01
"New Mexico","2018-07",2018,7,44000,16390,27610,91.4389799635701,"07",2018-07-01
"New Mexico","2018-08",2018,8,50000,14742,35258,108.918476414074,"08",2018-08-01
"New Mexico","2018-09",2018,9,49000,14227,34773,109.994148069654,"09",2018-09-01
"New Mexico","2019-01",2019,1,44000,12792,31208,109.90280321172,"01",2019-01-01
"New Mexico","2019-10",2019,10,49000,16082,32918,101.158538459175,"10",2019-10-01
"New Mexico","2019-11",2019,11,43000,15810,27190,92.4672674715184,"11",2019-11-01
"New Mexico","2019-12",2019,12,40000,15776,24224,86.8617326448652,"12",2019-12-01
"New Mexico","2019-02",2019,2,43000,11900,31100,113.296903460838,"02",2019-02-01
"New Mexico","2019-03",2019,3,43000,15976,27024,91.6440586001085,"03",2019-03-01
"New Mexico","2019-04",2019,4,42000,13569,28431,102.326836905469,"04",2019-04-01
"New Mexico","2019-05",2019,5,43000,18144,24856,81.3031532120895,"05",2019-05-01
"New Mexico","2019-06",2019,6,42000,13301,28699,103.791974828665,"06",2019-06-01
"New Mexico","2019-07",2019,7,44000,12691,31309,110.454922298072,"07",2019-07-01
"New Mexico","2019-08",2019,8,49000,17116,31884,96.4486659810031,"08",2019-08-01
"New Mexico","2019-09",2019,9,51000,22565,28435,77.3057840005437,"09",2019-09-01
"New York","2010-01",2010,1,137000,18508,118492,152.393445996347,"01",2010-01-01
"New York","2010-10",2010,10,186000,71998,114002,88.3743284831665,"10",2010-10-01
"New York","2010-11",2010,11,178000,62136,115864,96.4986507645667,"11",2010-11-01
"New York","2010-12",2010,12,169000,62943,106057,91.4509168200808,"12",2010-12-01
"New York","2010-02",2010,2,142000,42208,99792,108.347085902892,"02",2010-02-01
"New York","2010-03",2010,3,143000,52354,90646,92.8017854766219,"03",2010-03-01
"New York","2010-04",2010,4,154000,60347,93653,87.3844747069005,"04",2010-04-01
"New York","2010-05",2010,5,169000,66244,102756,87.3612079372906,"05",2010-05-01
"New York","2010-06",2010,6,183000,55080,127920,107.459677419355,"06",2010-06-01
"New York","2010-07",2010,7,183000,66564,116436,93.3115353175939,"07",2010-07-01
"New York","2010-08",2010,8,179000,81663,97337,74.6841707492049,"08",2010-08-01
"New York","2010-09",2010,9,179000,60265,118735,99.249785802353,"09",2010-09-01
"New York","2011-01",2011,1,160000,64259,95741,85.384310105726,"01",2011-01-01
"New York","2011-10",2011,10,217000,59086,157914,114.394790029194,"10",2011-10-01
"New York","2011-11",2011,11,219000,51338,167662,124.038795877753,"11",2011-11-01
"New York","2011-12",2011,12,205000,52038,152962,119.0189777387,"12",2011-12-01
"New York","2011-02",2011,2,168000,61306,106694,93.0581842603333,"02",2011-02-01
"New York","2011-03",2011,3,180000,75111,104889,82.2300880793067,"03",2011-03-01
"New York","2011-04",2011,4,193000,62162,130838,102.552887969212,"04",2011-04-01
"New York","2011-05",2011,5,199000,68219,130781,97.8830098159188,"05",2011-05-01
"New York","2011-06",2011,6,204000,65638,138362,102.62796786803,"06",2011-06-01
"New York","2011-07",2011,7,201000,76003,124997,90.2495640841435,"07",2011-07-01
"New York","2011-08",2011,8,205000,73479,131521,94.4566735732317,"08",2011-08-01
"New York","2011-09",2011,9,214000,63903,150097,108.021144068254,"09",2011-09-01
"New York","2012-01",2012,1,203000,69662,133338,97.8046079028247,"01",2012-01-01
"New York","2012-10",2012,10,260000,69749,190251,115.391403764682,"10",2012-10-01
"New York","2012-11",2012,11,238000,53900,184100,126.139088729017,"11",2012-11-01
"New York","2012-12",2012,12,226000,65367,160633,110.261628804909,"12",2012-12-01
"New York","2012-02",2012,2,198000,75413,122587,89.6716688672448,"02",2012-02-01
"New York","2012-03",2012,3,214000,81145,132855,90.0269359128564,"03",2012-03-01
"New York","2012-04",2012,4,227000,70735,156265,104.969184005911,"04",2012-04-01
"New York","2012-05",2012,5,240000,81594,158406,98.5130319595515,"05",2012-05-01
"New York","2012-06",2012,6,236000,71354,164646,107.13769789884,"06",2012-06-01
"New York","2012-07",2012,7,231000,67741,163259,109.29802069351,"07",2012-07-01
"New York","2012-08",2012,8,249000,63907,185093,118.305438996251,"08",2012-08-01
"New York","2012-09",2012,9,258000,60230,197770,124.293749803601,"09",2012-09-01
"New York","2013-01",2013,1,230000,82397,147603,94.4970662330304,"01",2013-01-01
"New York","2013-10",2013,10,254000,100258,153742,86.7966284459349,"10",2013-10-01
"New York","2013-11",2013,11,243000,77787,165213,103.004797575962,"11",2013-11-01
"New York","2013-12",2013,12,226000,75201,150799,100.131805671296,"12",2013-12-01
"New York","2013-02",2013,2,232000,74110,157890,103.158995132469,"02",2013-02-01
"New York","2013-03",2013,3,255000,70471,184529,113.391976550906,"03",2013-03-01
"New York","2013-04",2013,4,254000,68249,185751,115.284143628064,"04",2013-04-01
"New York","2013-05",2013,5,253000,67684,185316,115.57545745968,"05",2013-05-01
"New York","2013-06",2013,6,234000,76877,157123,101.083708347674,"06",2013-06-01
"New York","2013-07",2013,7,222000,118189,103811,61.0313678572793,"07",2013-07-01
"New York","2013-08",2013,8,229000,95755,133245,82.0587827747071,"08",2013-08-01
"New York","2013-09",2013,9,239000,98307,140693,83.4213342741182,"09",2013-09-01
"New York","2014-01",2014,1,212000,85188,126812,85.3412654615933,"01",2014-01-01
"New York","2014-10",2014,10,278000,81937,196063,108.942953905822,"10",2014-10-01
"New York","2014-11",2014,11,255000,67483,187517,116.295742721322,"11",2014-11-01
"New York","2014-12",2014,12,238000,68866,169134,110.233131073498,"12",2014-12-01
"New York","2014-02",2014,2,212000,81443,130557,88.9828689046936,"02",2014-02-01
"New York","2014-03",2014,3,232000,105658,126342,74.8342997944666,"03",2014-03-01
"New York","2014-04",2014,4,256000,93338,162662,93.1258551889574,"04",2014-04-01
"New York","2014-05",2014,5,274000,101850,172150,91.6056937608088,"05",2014-05-01
"New York","2014-06",2014,6,276000,76796,199204,112.928718012676,"06",2014-06-01
"New York","2014-07",2014,7,267000,72073,194927,114.976421006686,"07",2014-07-01
"New York","2014-08",2014,8,269000,82922,186078,105.749569506879,"08",2014-08-01
"New York","2014-09",2014,9,272000,91241,180759,99.5256592730446,"09",2014-09-01
"New York","2015-01",2015,1,249000,75059,173941,107.351439089795,"01",2015-01-01
"New York","2015-10",2015,10,311000,119459,191541,88.9938414576069,"10",2015-10-01
"New York","2015-11",2015,11,314000,99628,214372,103.654491475432,"11",2015-11-01
"New York","2015-12",2015,12,298000,84012,213988,112.032082761798,"12",2015-12-01
"New York","2015-02",2015,2,270000,66868,203132,120.600353847798,"02",2015-02-01
"New York","2015-03",2015,3,284000,95273,188727,99.5203982355717,"03",2015-03-01
"New York","2015-04",2015,4,283000,87410,195590,105.607300018898,"04",2015-04-01
"New York","2015-05",2015,5,286000,95181,190819,100.119890550683,"05",2015-05-01
"New York","2015-06",2015,6,285000,155877,129123,58.575521063698,"06",2015-06-01
"New York","2015-07",2015,7,299000,139689,159311,72.6304967756201,"07",2015-07-01
"New York","2015-08",2015,8,3e+05,110200,189800,92.5402242808386,"08",2015-08-01
"New York","2015-09",2015,9,320000,99791,220209,104.913635594856,"09",2015-09-01
"New York","2016-01",2016,1,292000,99360,192640,98.4464431725266,"01",2016-01-01
"New York","2016-10",2016,10,363000,99536,263464,113.921510974281,"10",2016-10-01
"New York","2016-11",2016,11,348000,91537,256463,116.696887861545,"11",2016-11-01
"New York","2016-12",2016,12,333000,79712,253288,122.743220453973,"12",2016-12-01
"New York","2016-02",2016,2,280000,90412,189588,102.36601406002,"02",2016-02-01
"New York","2016-03",2016,3,3e+05,115547,184453,88.7759988641477,"03",2016-03-01
"New York","2016-04",2016,4,320000,111523,208477,96.6238184291451,"04",2016-04-01
"New York","2016-05",2016,5,349000,105908,243092,106.875236311518,"05",2016-05-01
"New York","2016-06",2016,6,352000,104199,247801,108.637239450328,"06",2016-06-01
"New York","2016-07",2016,7,351000,102151,248849,109.83049800177,"07",2016-07-01
"New York","2016-08",2016,8,355000,92888,262112,117.043546600936,"08",2016-08-01
"New York","2016-09",2016,9,362000,107604,254396,108.344903365389,"09",2016-09-01
"New York","2017-01",2017,1,319000,95061,223939,108.167154114973,"01",2017-01-01
"New York","2017-10",2017,10,348000,93296,254704,115.434538269098,"10",2017-10-01
"New York","2017-11",2017,11,339000,86793,252207,118.464606040964,"11",2017-11-01
"New York","2017-12",2017,12,339000,69545,269455,131.909581563842,"12",2017-12-01
"New York","2017-02",2017,2,327000,104023,222977,103.464084283205,"02",2017-02-01
"New York","2017-03",2017,3,327000,116746,210254,94.76322040086,"03",2017-03-01
"New York","2017-04",2017,4,350000,109436,240564,104.721441071226,"04",2017-04-01
"New York","2017-05",2017,5,351000,119644,231356,98.3146497140089,"05",2017-05-01
"New York","2017-06",2017,6,355000,110281,244719,105.191916282848,"06",2017-06-01
"New York","2017-07",2017,7,341000,106392,234608,104.878048780488,"07",2017-07-01
"New York","2017-08",2017,8,344000,104408,239592,106.863392267756,"08",2017-08-01
"New York","2017-09",2017,9,345000,93698,251302,114.567196568026,"09",2017-09-01
"New York","2018-01",2018,1,346000,86837,259163,119.750853092504,"01",2018-01-01
"New York","2018-10",2018,10,406000,126583,279417,104.92899698263,"10",2018-10-01
"New York","2018-11",2018,11,404000,113403,290597,112.329074241935,"11",2018-11-01
"New York","2018-12",2018,12,381000,114106,266894,107.812872395002,"12",2018-12-01
"New York","2018-02",2018,2,361000,80617,280383,126.980166071505,"02",2018-02-01
"New York","2018-03",2018,3,392000,109175,282825,112.86476779568,"03",2018-03-01
"New York","2018-04",2018,4,409000,106225,302775,117.531175699937,"04",2018-04-01
"New York","2018-05",2018,5,410000,153008,256992,91.2924860747982,"05",2018-05-01
"New York","2018-06",2018,6,399000,99107,299893,120.413083935781,"06",2018-06-01
"New York","2018-07",2018,7,395000,138632,256368,96.0841928520029,"07",2018-07-01
"New York","2018-08",2018,8,405000,121869,283131,107.476811123828,"08",2018-08-01
"New York","2018-09",2018,9,410000,113135,296865,113.494604643161,"09",2018-09-01
"New York","2019-01",2019,1,368000,121963,246037,100.430848860016,"01",2019-01-01
"New York","2019-10",2019,10,452000,161456,290544,94.7236639628596,"10",2019-10-01
"New York","2019-11",2019,11,409000,140170,268830,97.9041098384835,"11",2019-11-01
"New York","2019-12",2019,12,392000,140418,251582,94.5054449699296,"12",2019-12-01
"New York","2019-02",2019,2,355000,115559,239441,101.768747383431,"02",2019-02-01
"New York","2019-03",2019,3,366000,143764,222236,87.1917200900809,"03",2019-03-01
"New York","2019-04",2019,4,350000,129522,220478,91.9574075850534,"04",2019-04-01
"New York","2019-05",2019,5,366000,141594,224406,88.4194848638873,"05",2019-05-01
"New York","2019-06",2019,6,372000,125164,246836,99.2976160783967,"06",2019-06-01
"New York","2019-07",2019,7,4e+05,106837,293163,115.683345927783,"07",2019-07-01
"New York","2019-08",2019,8,428000,156031,271969,93.1351246766011,"08",2019-08-01
"New York","2019-09",2019,9,435000,178430,256570,83.6509463182433,"09",2019-09-01
"North Carolina","2010-01",2010,1,66000,11372,54628,141.208705991832,"01",2010-01-01
"North Carolina","2010-10",2010,10,78000,34650,43350,76.9640479360852,"10",2010-10-01
"North Carolina","2010-11",2010,11,77000,30740,46260,85.873398923334,"11",2010-11-01
"North Carolina","2010-12",2010,12,72000,37422,34578,63.2011844053298,"12",2010-12-01
"North Carolina","2010-02",2010,2,66000,20690,45310,104.533394855231,"02",2010-02-01
"North Carolina","2010-03",2010,3,68000,29296,38704,79.5592830126624,"03",2010-03-01
"North Carolina","2010-04",2010,4,75000,27650,47350,92.2552362396493,"04",2010-04-01
"North Carolina","2010-05",2010,5,87000,32662,54338,90.8191405792983,"05",2010-05-01
"North Carolina","2010-06",2010,6,89000,31812,57188,94.6727146309969,"06",2010-06-01
"North Carolina","2010-07",2010,7,83000,34584,48416,82.3513403184107,"07",2010-07-01
"North Carolina","2010-08",2010,8,75000,34352,40648,74.343404784549,"08",2010-08-01
"North Carolina","2010-09",2010,9,77000,30699,46301,85.9822282472446,"09",2010-09-01
"North Carolina","2011-01",2011,1,68000,38266,29734,55.9614552161557,"01",2011-01-01
"North Carolina","2011-10",2011,10,112000,27872,84128,120.292839167239,"10",2011-10-01
"North Carolina","2011-11",2011,11,111000,24069,86931,128.720875996713,"11",2011-11-01
"North Carolina","2011-12",2011,12,110000,29804,80196,114.726331149323,"12",2011-12-01
"North Carolina","2011-02",2011,2,72000,24046,47954,99.856318847219,"02",2011-02-01
"North Carolina","2011-03",2011,3,83000,38486,44514,73.2825181502395,"03",2011-03-01
"North Carolina","2011-04",2011,4,91000,29964,61036,100.915975000827,"04",2011-04-01
"North Carolina","2011-05",2011,5,88000,37903,50097,79.5803118273592,"05",2011-05-01
"North Carolina","2011-06",2011,6,89000,35322,53678,86.3531796464021,"06",2011-06-01
"North Carolina","2011-07",2011,7,92000,34007,57993,92.0472672153134,"07",2011-07-01
"North Carolina","2011-08",2011,8,1e+05,30595,69405,106.290439909644,"08",2011-08-01
"North Carolina","2011-09",2011,9,102000,27386,74614,115.335507705625,"09",2011-09-01
"North Carolina","2012-01",2012,1,98000,35203,62797,94.2876661937043,"01",2012-01-01
"North Carolina","2012-10",2012,10,121000,28918,92082,122.843154257661,"10",2012-10-01
"North Carolina","2012-11",2012,11,110000,25072,84928,125.752191423833,"11",2012-11-01
"North Carolina","2012-12",2012,12,101000,27214,73786,115.098195204892,"12",2012-12-01
"North Carolina","2012-02",2012,2,97000,34167,62833,95.8061097684631,"02",2012-02-01
"North Carolina","2012-03",2012,3,102000,39744,62256,87.8428716559431,"03",2012-03-01
"North Carolina","2012-04",2012,4,107000,36930,70070,97.3667755158758,"04",2012-04-01
"North Carolina","2012-05",2012,5,114000,41579,72421,93.0986829842074,"05",2012-05-01
"North Carolina","2012-06",2012,6,115000,34705,80295,107.270966233593,"06",2012-06-01
"North Carolina","2012-07",2012,7,122000,27689,94311,126.009259197403,"07",2012-07-01
"North Carolina","2012-08",2012,8,126000,24229,101771,135.487821925194,"08",2012-08-01
"North Carolina","2012-09",2012,9,129000,23187,105813,139.056555421948,"09",2012-09-01
"North Carolina","2013-01",2013,1,106000,40461,65539,89.4968626460286,"01",2013-01-01
"North Carolina","2013-10",2013,10,133000,43302,89698,101.754943222425,"10",2013-10-01
"North Carolina","2013-11",2013,11,127000,40952,86048,102.46737162999,"11",2013-11-01
"North Carolina","2013-12",2013,12,121000,37266,83734,105.814262065131,"12",2013-12-01
"North Carolina","2013-02",2013,2,113000,32617,80383,110.403318293881,"02",2013-02-01
"North Carolina","2013-03",2013,3,124000,32461,91539,117.011907120624,"03",2013-03-01
"North Carolina","2013-04",2013,4,133000,27722,105278,131.006333918194,"04",2013-04-01
"North Carolina","2013-05",2013,5,142000,31131,110869,128.075272481531,"05",2013-05-01
"North Carolina","2013-06",2013,6,151000,46451,104549,105.898678659516,"06",2013-06-01
"North Carolina","2013-07",2013,7,144000,64965,79035,75.6442466441749,"07",2013-07-01
"North Carolina","2013-08",2013,8,141000,59250,81750,81.6479400749064,"08",2013-08-01
"North Carolina","2013-09",2013,9,134000,51579,82421,88.8257830896815,"09",2013-09-01
"North Carolina","2014-01",2014,1,120000,53256,66744,77.0466823659787,"01",2014-01-01
"North Carolina","2014-10",2014,10,152000,43666,108334,110.733597048031,"10",2014-10-01
"North Carolina","2014-11",2014,11,143000,35659,107341,120.16299206869,"11",2014-11-01
"North Carolina","2014-12",2014,12,142000,32642,109358,125.236770078217,"12",2014-12-01
"North Carolina","2014-02",2014,2,122000,43672,78328,94.5579216765658,"02",2014-02-01
"North Carolina","2014-03",2014,3,128000,51066,76934,85.9280935520981,"03",2014-03-01
"North Carolina","2014-04",2014,4,133000,51364,81636,88.5595886398646,"04",2014-04-01
"North Carolina","2014-05",2014,5,141000,54118,86882,89.055853381031,"05",2014-05-01
"North Carolina","2014-06",2014,6,141000,40401,100599,110.913390775134,"06",2014-06-01
"North Carolina","2014-07",2014,7,138000,32297,105703,124.139591419696,"07",2014-07-01
"North Carolina","2014-08",2014,8,142000,36238,105762,118.675030016046,"08",2014-08-01
"North Carolina","2014-09",2014,9,142000,36638,105362,117.961463966233,"09",2014-09-01
"North Carolina","2015-01",2015,1,141000,38737,102263,113.791818045255,"01",2015-01-01
"North Carolina","2015-10",2015,10,199000,51933,147067,117.216149330698,"10",2015-10-01
"North Carolina","2015-11",2015,11,191000,39008,151992,132.162359570102,"11",2015-11-01
"North Carolina","2015-12",2015,12,179000,39028,139972,128.398187388776,"12",2015-12-01
"North Carolina","2015-02",2015,2,147000,34525,112475,123.922324748657,"02",2015-02-01
"North Carolina","2015-03",2015,3,158000,36721,121279,124.56694450008,"03",2015-03-01
"North Carolina","2015-04",2015,4,169000,47540,121460,112.182506696222,"04",2015-04-01
"North Carolina","2015-05",2015,5,181000,49132,131868,114.602054473085,"05",2015-05-01
"North Carolina","2015-06",2015,6,174000,52629,121371,107.109857961691,"06",2015-06-01
"North Carolina","2015-07",2015,7,174000,58283,115717,99.6344975740799,"07",2015-07-01
"North Carolina","2015-08",2015,8,173000,54101,118899,104.710239056631,"08",2015-08-01
"North Carolina","2015-09",2015,9,196000,48581,147419,120.548202844865,"09",2015-09-01
"North Carolina","2016-01",2016,1,184000,48468,135532,116.602715212416,"01",2016-01-01
"North Carolina","2016-10",2016,10,182000,55858,126142,106.064963129262,"10",2016-10-01
"North Carolina","2016-11",2016,11,180000,47034,132966,117.133116625704,"11",2016-11-01
"North Carolina","2016-12",2016,12,163000,39916,123084,121.31522403359,"12",2016-12-01
"North Carolina","2016-02",2016,2,195000,43834,151166,126.586666889974,"02",2016-02-01
"North Carolina","2016-03",2016,3,206000,51432,154568,120.084527176109,"03",2016-03-01
"North Carolina","2016-04",2016,4,196000,50525,145475,118.020484737856,"04",2016-04-01
"North Carolina","2016-05",2016,5,190000,44366,145634,124.279118984836,"05",2016-05-01
"North Carolina","2016-06",2016,6,183000,50218,132782,113.869426888148,"06",2016-06-01
"North Carolina","2016-07",2016,7,187000,51049,135951,114.221021722418,"07",2016-07-01
"North Carolina","2016-08",2016,8,184000,47091,136909,118.489253151356,"08",2016-08-01
"North Carolina","2016-09",2016,9,190000,59494,130506,104.616543884823,"09",2016-09-01
"North Carolina","2017-01",2017,1,161000,48888,112112,106.830309498399,"01",2017-01-01
"North Carolina","2017-10",2017,10,214000,46798,167202,128.223375946135,"10",2017-10-01
"North Carolina","2017-11",2017,11,214000,41104,172896,135.549422980432,"11",2017-11-01
"North Carolina","2017-12",2017,12,205000,33856,171144,143.303078005158,"12",2017-12-01
"North Carolina","2017-02",2017,2,169000,45924,123076,114.529787273641,"02",2017-02-01
"North Carolina","2017-03",2017,3,182000,60181,121819,100.601616146601,"03",2017-03-01
"North Carolina","2017-04",2017,4,198000,46670,151330,123.701311971227,"04",2017-04-01
"North Carolina","2017-05",2017,5,204000,50210,153790,120.994453404665,"05",2017-05-01
"North Carolina","2017-06",2017,6,219000,51764,167236,123.528977264334,"06",2017-06-01
"North Carolina","2017-07",2017,7,223000,51470,171530,124.989980690057,"07",2017-07-01
"North Carolina","2017-08",2017,8,224000,52142,171858,124.470743313223,"08",2017-08-01
"North Carolina","2017-09",2017,9,215000,46154,168846,129.307611600818,"09",2017-09-01
"North Carolina","2018-01",2018,1,198000,47124,150876,123.101777059774,"01",2018-01-01
"North Carolina","2018-10",2018,10,255000,87431,167569,97.8702278707243,"10",2018-10-01
"North Carolina","2018-11",2018,11,266000,87645,178355,100.866688345657,"11",2018-11-01
"North Carolina","2018-12",2018,12,264000,79724,184276,107.22323724849,"12",2018-12-01
"North Carolina","2018-02",2018,2,199000,47612,151388,122.774236452403,"02",2018-02-01
"North Carolina","2018-03",2018,3,212000,61561,150439,109.985707026952,"03",2018-03-01
"North Carolina","2018-04",2018,4,231000,67668,163332,109.373618867773,"04",2018-04-01
"North Carolina","2018-05",2018,5,248000,94958,153042,89.2482461409269,"05",2018-05-01
"North Carolina","2018-06",2018,6,258000,69382,188618,115.228082179228,"06",2018-06-01
"North Carolina","2018-07",2018,7,244000,94752,149248,88.116380124693,"07",2018-07-01
"North Carolina","2018-08",2018,8,240000,84189,155811,96.1235575543896,"08",2018-08-01
"North Carolina","2018-09",2018,9,239000,80604,158396,99.1201611994844,"09",2018-09-01
"North Carolina","2019-01",2019,1,262000,77470,184530,108.716528706513,"01",2019-01-01
"North Carolina","2019-10",2019,10,304000,130706,173294,79.7292883005986,"10",2019-10-01
"North Carolina","2019-11",2019,11,291000,102786,188214,95.5920220627447,"11",2019-11-01
"North Carolina","2019-12",2019,12,276000,95004,180996,97.570915677459,"12",2019-12-01
"North Carolina","2019-02",2019,2,264000,77937,186063,108.828819343914,"02",2019-02-01
"North Carolina","2019-03",2019,3,286000,101205,184795,95.4507302333389,"03",2019-03-01
"North Carolina","2019-04",2019,4,292000,84915,207085,109.884191395938,"04",2019-04-01
"North Carolina","2019-05",2019,5,292000,101534,190466,96.7977353926217,"05",2019-05-01
"North Carolina","2019-06",2019,6,285000,83173,201827,109.637045628006,"06",2019-06-01
"North Carolina","2019-07",2019,7,280000,77237,202763,113.517356824741,"07",2019-07-01
"North Carolina","2019-08",2019,8,281000,97490,183510,96.9695368437739,"08",2019-08-01
"North Carolina","2019-09",2019,9,277000,120087,156913,79.0320509107576,"09",2019-09-01
"North Dakota","2010-01",2010,1,7000,1053,5947,147.696510617161,"01",2010-01-01
"North Dakota","2010-10",2010,10,9000,2527,6473,112.310228159972,"10",2010-10-01
"North Dakota","2010-11",2010,11,9000,2684,6316,108.11365970558,"11",2010-11-01
"North Dakota","2010-12",2010,12,9000,2916,6084,102.114803625378,"12",2010-12-01
"North Dakota","2010-02",2010,2,7000,1263,5737,138.859978216144,"02",2010-02-01
"North Dakota","2010-03",2010,3,7000,1613,5387,125.089980262394,"03",2010-03-01
"North Dakota","2010-04",2010,4,8000,1620,6380,132.640332640333,"04",2010-04-01
"North Dakota","2010-05",2010,5,8000,2060,5940,118.091451292247,"05",2010-05-01
"North Dakota","2010-06",2010,6,9000,2026,6974,126.500997641937,"06",2010-06-01
"North Dakota","2010-07",2010,7,9000,2817,6183,104.645849200305,"07",2010-07-01
"North Dakota","2010-08",2010,8,9000,2658,6342,108.800823468863,"08",2010-08-01
"North Dakota","2010-09",2010,9,9000,2475,6525,113.725490196078,"09",2010-09-01
"North Dakota","2011-01",2011,1,8000,2906,5094,93.4164679992665,"01",2011-01-01
"North Dakota","2011-10",2011,10,15000,2939,12061,134.466804169686,"10",2011-10-01
"North Dakota","2011-11",2011,11,14000,3002,10998,129.373014939419,"11",2011-11-01
"North Dakota","2011-12",2011,12,13000,3401,9599,117.053838180599,"12",2011-12-01
"North Dakota","2011-02",2011,2,9000,2211,6789,121.113192400321,"02",2011-02-01
"North Dakota","2011-03",2011,3,9000,4153,4847,73.7018170759523,"03",2011-03-01
"North Dakota","2011-04",2011,4,11000,2735,8265,120.349472151438,"04",2011-04-01
"North Dakota","2011-05",2011,5,12000,3712,8288,105.498981670061,"05",2011-05-01
"North Dakota","2011-06",2011,6,13000,3027,9973,124.452486429151,"06",2011-06-01
"North Dakota","2011-07",2011,7,14000,3655,10345,117.190597564429,"07",2011-07-01
"North Dakota","2011-08",2011,8,14000,2657,11343,136.194993095996,"08",2011-08-01
"North Dakota","2011-09",2011,9,15000,3141,11859,130.742516950554,"09",2011-09-01
"North Dakota","2012-01",2012,1,13000,3456,9544,115.994166261546,"01",2012-01-01
"North Dakota","2012-10",2012,10,16000,5314,10686,100.272121610209,"10",2012-10-01
"North Dakota","2012-11",2012,11,16000,3376,12624,130.305532617671,"11",2012-11-01
"North Dakota","2012-12",2012,12,15000,3669,11331,121.388397878837,"12",2012-12-01
"North Dakota","2012-02",2012,2,13000,4386,8614,99.091222822961,"02",2012-02-01
"North Dakota","2012-03",2012,3,14000,3874,10126,113.304240796688,"03",2012-03-01
"North Dakota","2012-04",2012,4,14000,3882,10118,113.164075606755,"04",2012-04-01
"North Dakota","2012-05",2012,5,15000,3828,11172,118.674314850223,"05",2012-05-01
"North Dakota","2012-06",2012,6,15000,3937,11063,116.840048582141,"06",2012-06-01
"North Dakota","2012-07",2012,7,16000,3283,12717,131.89856350153,"07",2012-07-01
"North Dakota","2012-08",2012,8,15000,3519,11481,123.991576219018,"08",2012-08-01
"North Dakota","2012-09",2012,9,16000,3130,12870,134.553058024046,"09",2012-09-01
"North Dakota","2013-01",2013,1,13000,5258,7742,84.8066600942053,"01",2013-01-01
"North Dakota","2013-10",2013,10,16000,7431,8569,73.1424181639708,"10",2013-10-01
"North Dakota","2013-11",2013,11,16000,6064,9936,90.065264684554,"11",2013-11-01
"North Dakota","2013-12",2013,12,14000,5235,8765,91.13595009098,"12",2013-12-01
"North Dakota","2013-02",2013,2,14000,4076,9924,109.803053772959,"02",2013-02-01
"North Dakota","2013-03",2013,3,14000,4564,9436,101.659125188537,"03",2013-03-01
"North Dakota","2013-04",2013,4,14000,3627,10373,117.69444602031,"04",2013-04-01
"North Dakota","2013-05",2013,5,14000,3614,10386,117.928920177132,"05",2013-05-01
"North Dakota","2013-06",2013,6,15000,4901,10099,101.49238731722,"06",2013-06-01
"North Dakota","2013-07",2013,7,15000,8800,6200,52.1008403361345,"07",2013-07-01
"North Dakota","2013-08",2013,8,15000,9686,5314,43.0527424451106,"08",2013-08-01
"North Dakota","2013-09",2013,9,15000,9034,5966,49.6463343596572,"09",2013-09-01
"North Dakota","2014-01",2014,1,13000,7376,5624,55.2021986650962,"01",2014-01-01
"North Dakota","2014-10",2014,10,20000,5298,14702,116.23053205787,"10",2014-10-01
"North Dakota","2014-11",2014,11,18000,5138,12862,111.176419742415,"11",2014-11-01
"North Dakota","2014-12",2014,12,17000,4181,12819,121.042443699542,"12",2014-12-01
"North Dakota","2014-02",2014,2,14000,6236,7764,76.7345325163076,"02",2014-02-01
"North Dakota","2014-03",2014,3,15000,7476,7524,66.9514148424987,"03",2014-03-01
"North Dakota","2014-04",2014,4,16000,7243,8757,75.3517187970572,"04",2014-04-01
"North Dakota","2014-05",2014,5,17000,7150,9850,81.5734989648033,"05",2014-05-01
"North Dakota","2014-06",2014,6,19000,6008,12992,103.902751119642,"06",2014-06-01
"North Dakota","2014-07",2014,7,19000,3996,15004,130.492259523395,"07",2014-07-01
"North Dakota","2014-08",2014,8,20000,6184,13816,105.530094714329,"08",2014-08-01
"North Dakota","2014-09",2014,9,20000,5075,14925,119.042871385842,"09",2014-09-01
"North Dakota","2015-01",2015,1,18000,5060,12940,112.228967909801,"01",2015-01-01
"North Dakota","2015-10",2015,10,20000,4673,15327,124.241073237952,"10",2015-10-01
"North Dakota","2015-11",2015,11,20000,3695,16305,137.623971301962,"11",2015-11-01
"North Dakota","2015-12",2015,12,18000,3972,14028,127.689787001638,"12",2015-12-01
"North Dakota","2015-02",2015,2,19000,3947,15053,131.197977949187,"02",2015-02-01
"North Dakota","2015-03",2015,3,19000,5821,13179,106.192337133879,"03",2015-03-01
"North Dakota","2015-04",2015,4,18000,4709,13291,117.054912149368,"04",2015-04-01
"North Dakota","2015-05",2015,5,18000,5254,12746,109.624150683753,"05",2015-05-01
"North Dakota","2015-06",2015,6,19000,4439,14561,124.245914928111,"06",2015-06-01
"North Dakota","2015-07",2015,7,20000,5052,14948,119.335781574325,"07",2015-07-01
"North Dakota","2015-08",2015,8,20000,4981,15019,120.243384972579,"08",2015-08-01
"North Dakota","2015-09",2015,9,20000,4512,15488,126.370757180157,"09",2015-09-01
"North Dakota","2016-01",2016,1,17000,4639,12361,114.247423633255,"01",2016-01-01
"North Dakota","2016-10",2016,10,17000,6621,10379,87.8794293213666,"10",2016-10-01
"North Dakota","2016-11",2016,11,17000,5230,11770,105.892937471885,"11",2016-11-01
"North Dakota","2016-12",2016,12,16000,5505,10495,97.6052080911416,"12",2016-12-01
"North Dakota","2016-02",2016,2,17000,4279,12721,119.563889280511,"02",2016-02-01
"North Dakota","2016-03",2016,3,17000,6508,10492,89.2632295388804,"03",2016-03-01
"North Dakota","2016-04",2016,4,17000,5398,11602,103.598535583534,"04",2016-04-01
"North Dakota","2016-05",2016,5,18000,4817,13183,115.554192049787,"05",2016-05-01
"North Dakota","2016-06",2016,6,18000,5509,12491,106.265685482156,"06",2016-06-01
"North Dakota","2016-07",2016,7,19000,5661,13339,108.178905964884,"07",2016-07-01
"North Dakota","2016-08",2016,8,19000,6693,12307,95.8004125637333,"08",2016-08-01
"North Dakota","2016-09",2016,9,19000,7503,11497,86.7599894351583,"09",2016-09-01
"North Dakota","2017-01",2017,1,16000,5603,10397,96.2551497477202,"01",2017-01-01
"North Dakota","2017-10",2017,10,21000,4402,16598,130.682623415479,"10",2017-10-01
"North Dakota","2017-11",2017,11,20000,4233,15767,130.128337391161,"11",2017-11-01
"North Dakota","2017-12",2017,12,19000,3111,15889,143.720320202614,"12",2017-12-01
"North Dakota","2017-02",2017,2,16000,5779,10221,93.8610588181275,"02",2017-02-01
"North Dakota","2017-03",2017,3,17000,8709,8291,64.498813645027,"03",2017-03-01
"North Dakota","2017-04",2017,4,19000,4812,14188,119.166806652108,"04",2017-04-01
"North Dakota","2017-05",2017,5,19000,5098,13902,115.378869615736,"05",2017-05-01
"North Dakota","2017-06",2017,6,20000,4912,15088,121.130378933847,"06",2017-06-01
"North Dakota","2017-07",2017,7,20000,5033,14967,119.57815683298,"07",2017-07-01
"North Dakota","2017-08",2017,8,20000,3560,16440,139.55857385399,"08",2017-08-01
"North Dakota","2017-09",2017,9,20000,4156,15844,131.180659049512,"09",2017-09-01
"North Dakota","2018-01",2018,1,19000,4104,14896,128.947368421053,"01",2018-01-01
"North Dakota","2018-10",2018,10,26000,4527,21473,140.682019196121,"10",2018-10-01
"North Dakota","2018-11",2018,11,25000,3594,21406,149.723718262573,"11",2018-11-01
"North Dakota","2018-12",2018,12,24000,3885,20115,144.271113501883,"12",2018-12-01
"North Dakota","2018-02",2018,2,20000,5056,14944,119.284802043423,"02",2018-02-01
"North Dakota","2018-03",2018,3,21000,6490,14510,105.565660240087,"03",2018-03-01
"North Dakota","2018-04",2018,4,22000,20215,1785,8.45670970034348,"04",2018-04-01
"North Dakota","2018-05",2018,5,24000,14184,9816,51.414204902577,"05",2018-05-01
"North Dakota","2018-06",2018,6,25000,8444,16556,99.007295778017,"06",2018-06-01
"North Dakota","2018-07",2018,7,25000,4415,20585,139.962604113548,"07",2018-07-01
"North Dakota","2018-08",2018,8,24000,4788,19212,133.472280116715,"08",2018-08-01
"North Dakota","2018-09",2018,9,24000,4823,19177,133.067342053221,"09",2018-09-01
"North Dakota","2019-01",2019,1,24000,3845,20155,144.765667085653,"01",2019-01-01
"North Dakota","2019-10",2019,10,27000,6179,20821,125.507097863106,"10",2019-10-01
"North Dakota","2019-11",2019,11,24000,7054,16946,109.138919301861,"11",2019-11-01
"North Dakota","2019-12",2019,12,23000,5520,17480,122.58064516129,"12",2019-12-01
"North Dakota","2019-02",2019,2,24000,3373,20627,150.71055419574,"02",2019-02-01
"North Dakota","2019-03",2019,3,25000,5845,19155,124.201653428432,"03",2019-03-01
"North Dakota","2019-04",2019,4,26000,4303,21697,143.200343200343,"04",2019-04-01
"North Dakota","2019-05",2019,5,28000,4561,23439,143.969779797918,"05",2019-05-01
"North Dakota","2019-06",2019,6,29000,3895,25105,152.637178902569,"06",2019-06-01
"North Dakota","2019-07",2019,7,28000,3323,24677,157.564728793538,"07",2019-07-01
"North Dakota","2019-08",2019,8,26000,4699,21301,138.773249942995,"08",2019-08-01
"North Dakota","2019-09",2019,9,26000,9156,16844,95.8243258618728,"09",2019-09-01
"Ohio","2010-01",2010,1,83000,7881,75119,165.312881680439,"01",2010-01-01
"Ohio","2010-10",2010,10,105000,46528,58472,77.1764954331873,"10",2010-10-01
"Ohio","2010-11",2010,11,103000,37584,65416,93.0632219882775,"11",2010-11-01
"Ohio","2010-12",2010,12,96000,39030,56970,84.3812486114197,"12",2010-12-01
"Ohio","2010-02",2010,2,85000,18814,66186,127.508813840137,"02",2010-02-01
"Ohio","2010-03",2010,3,97000,25322,71678,117.195598502314,"03",2010-03-01
"Ohio","2010-04",2010,4,98000,27498,70502,112.355575387656,"04",2010-04-01
"Ohio","2010-05",2010,5,102000,33162,68838,101.859990233942,"05",2010-05-01
"Ohio","2010-06",2010,6,94000,29436,64564,104.611296542338,"06",2010-06-01
"Ohio","2010-07",2010,7,95000,38280,56720,85.1140456182473,"07",2010-07-01
"Ohio","2010-08",2010,8,98000,38520,59480,87.1374157632581,"08",2010-08-01
"Ohio","2010-09",2010,9,108000,37589,70411,96.725714167966,"09",2010-09-01
"Ohio","2011-01",2011,1,95000,44862,50138,71.6963864380604,"01",2011-01-01
"Ohio","2011-10",2011,10,131000,38568,92432,109.020569918853,"10",2011-10-01
"Ohio","2011-11",2011,11,125000,30275,94725,122.00933827081,"11",2011-11-01
"Ohio","2011-12",2011,12,120000,29914,90086,120.183571914564,"12",2011-12-01
"Ohio","2011-02",2011,2,85000,33777,51223,86.2507051028398,"02",2011-02-01
"Ohio","2011-03",2011,3,92000,44875,47125,68.8584474885845,"03",2011-03-01
"Ohio","2011-04",2011,4,99000,38640,60360,87.7070619006103,"04",2011-04-01
"Ohio","2011-05",2011,5,108000,44110,63890,84.0049963841956,"05",2011-05-01
"Ohio","2011-06",2011,6,116000,44344,71656,89.3778376490545,"06",2011-06-01
"Ohio","2011-07",2011,7,122000,39831,82169,101.549146949596,"07",2011-07-01
"Ohio","2011-08",2011,8,131000,39290,91710,107.710376416701,"08",2011-08-01
"Ohio","2011-09",2011,9,134000,45519,88481,98.5756382332789,"09",2011-09-01
"Ohio","2012-01",2012,1,114000,44629,69371,87.4632002975496,"01",2012-01-01
"Ohio","2012-10",2012,10,171000,35383,135617,131.422646245088,"10",2012-10-01
"Ohio","2012-11",2012,11,161000,30970,130030,135.469083710997,"11",2012-11-01
"Ohio","2012-12",2012,12,142000,36909,105091,117.479836117803,"12",2012-12-01
"Ohio","2012-02",2012,2,120000,43648,76352,93.3124755572937,"02",2012-02-01
"Ohio","2012-03",2012,3,129000,43385,85615,99.329988108014,"03",2012-03-01
"Ohio","2012-04",2012,4,138000,41046,96954,108.300660165544,"04",2012-04-01
"Ohio","2012-05",2012,5,143000,42229,100771,108.806936278876,"05",2012-05-01
"Ohio","2012-06",2012,6,136000,37485,98515,113.571778539931,"06",2012-06-01
"Ohio","2012-07",2012,7,134000,31828,102172,123.226475625347,"07",2012-07-01
"Ohio","2012-08",2012,8,141000,27568,113432,134.583076265958,"08",2012-08-01
"Ohio","2012-09",2012,9,158000,29661,128339,136.777487064441,"09",2012-09-01
"Ohio","2013-01",2013,1,123000,54449,68551,77.2627628219939,"01",2013-01-01
"Ohio","2013-10",2013,10,182000,46626,135374,118.423976275664,"10",2013-10-01
"Ohio","2013-11",2013,11,176000,42784,133216,121.778557847009,"11",2013-11-01
"Ohio","2013-12",2013,12,160000,43161,116839,115.021091646527,"12",2013-12-01
"Ohio","2013-02",2013,2,118000,40634,77366,97.5402498833793,"02",2013-02-01
"Ohio","2013-03",2013,3,131000,41160,89840,104.368029739777,"03",2013-03-01
"Ohio","2013-04",2013,4,144000,29482,114518,132.022918804256,"04",2013-04-01
"Ohio","2013-05",2013,5,160000,33232,126768,131.208081477188,"05",2013-05-01
"Ohio","2013-06",2013,6,163000,48078,114922,108.890552307678,"06",2013-06-01
"Ohio","2013-07",2013,7,164000,66871,97129,84.1413603267626,"07",2013-07-01
"Ohio","2013-08",2013,8,166000,53828,112172,102.054333387921,"08",2013-08-01
"Ohio","2013-09",2013,9,168000,50508,117492,107.540227360097,"09",2013-09-01
"Ohio","2014-01",2014,1,140000,56812,83188,84.5354958031014,"01",2014-01-01
"Ohio","2014-10",2014,10,198000,59122,138878,108.024984248722,"10",2014-10-01
"Ohio","2014-11",2014,11,184000,53165,130835,110.332468956212,"11",2014-11-01
"Ohio","2014-12",2014,12,173000,52398,120602,107.012484582827,"12",2014-12-01
"Ohio","2014-02",2014,2,136000,54347,81653,85.7938396717574,"02",2014-02-01
"Ohio","2014-03",2014,3,150000,58083,91917,88.3464771269157,"03",2014-03-01
"Ohio","2014-04",2014,4,172000,62935,109065,92.8469576691425,"04",2014-04-01
"Ohio","2014-05",2014,5,188000,66158,121842,95.8789414458723,"05",2014-05-01
"Ohio","2014-06",2014,6,198000,57951,140049,109.434227645135,"06",2014-06-01
"Ohio","2014-07",2014,7,198000,44371,153629,126.771767249382,"07",2014-07-01
"Ohio","2014-08",2014,8,201000,56951,144049,111.687103364593,"08",2014-08-01
"Ohio","2014-09",2014,9,2e+05,53044,146956,116.150550892335,"09",2014-09-01
"Ohio","2015-01",2015,1,170000,58150,111850,98.0495288187596,"01",2015-01-01
"Ohio","2015-10",2015,10,235000,75340,159660,102.89360056712,"10",2015-10-01
"Ohio","2015-11",2015,11,234000,64382,169618,113.69184468232,"11",2015-11-01
"Ohio","2015-12",2015,12,225000,63627,161373,111.821139394443,"12",2015-12-01
"Ohio","2015-02",2015,2,181000,48803,132197,115.052457974874,"02",2015-02-01
"Ohio","2015-03",2015,3,196000,60026,135974,106.218899643005,"03",2015-03-01
"Ohio","2015-04",2015,4,209000,65210,143790,104.875825097553,"04",2015-04-01
"Ohio","2015-05",2015,5,217000,70058,146942,102.377916657958,"05",2015-05-01
"Ohio","2015-06",2015,6,218000,70823,147177,101.915013693508,"06",2015-06-01
"Ohio","2015-07",2015,7,220000,82653,137347,90.7620278008148,"07",2015-07-01
"Ohio","2015-08",2015,8,219000,85640,133360,87.5525210084034,"08",2015-08-01
"Ohio","2015-09",2015,9,229000,81691,147309,94.8266927590436,"09",2015-09-01
"Ohio","2016-01",2016,1,218000,68237,149763,104.642656260372,"01",2016-01-01
"Ohio","2016-10",2016,10,234000,81475,152525,96.695459228148,"10",2016-10-01
"Ohio","2016-11",2016,11,231000,63255,167745,114.013355762859,"11",2016-11-01
"Ohio","2016-12",2016,12,221000,59802,161198,114.812572560025,"12",2016-12-01
"Ohio","2016-02",2016,2,223000,59576,163424,115.667289507955,"02",2016-02-01
"Ohio","2016-03",2016,3,240000,66023,173977,113.701911294249,"03",2016-03-01
"Ohio","2016-04",2016,4,246000,63130,182870,118.312683984084,"04",2016-04-01
"Ohio","2016-05",2016,5,252000,66068,185932,116.913364437793,"05",2016-05-01
"Ohio","2016-06",2016,6,239000,70373,168627,109.012098664072,"06",2016-06-01
"Ohio","2016-07",2016,7,244000,76856,167144,104.186301643105,"07",2016-07-01
"Ohio","2016-08",2016,8,247000,73557,173443,108.213515848975,"08",2016-08-01
"Ohio","2016-09",2016,9,253000,96259,156741,89.7563126504972,"09",2016-09-01
"Ohio","2017-01",2017,1,231000,70352,160648,106.61817409541,"01",2017-01-01
"Ohio","2017-10",2017,10,270000,54242,215758,133.084547961091,"10",2017-10-01
"Ohio","2017-11",2017,11,255000,49748,205252,134.702770813918,"11",2017-11-01
"Ohio","2017-12",2017,12,240000,40388,199612,142.382698260981,"12",2017-12-01
"Ohio","2017-02",2017,2,223000,58733,164267,116.611827510444,"02",2017-02-01
"Ohio","2017-03",2017,3,244000,74393,169607,106.539402562242,"03",2017-03-01
"Ohio","2017-04",2017,4,252000,66833,185167,116.152970363795,"04",2017-04-01
"Ohio","2017-05",2017,5,244000,63848,180152,117.039577973545,"05",2017-05-01
"Ohio","2017-06",2017,6,238000,68127,169873,110.982043400288,"06",2017-06-01
"Ohio","2017-07",2017,7,231000,68685,162315,108.323739926923,"07",2017-07-01
"Ohio","2017-08",2017,8,254000,64532,189468,118.963243881305,"08",2017-08-01
"Ohio","2017-09",2017,9,257000,55776,201224,128.669718904264,"09",2017-09-01
"Ohio","2018-01",2018,1,231000,56658,174342,121.21477587969,"01",2018-01-01
"Ohio","2018-10",2018,10,287000,98530,188470,97.7718984255441,"10",2018-10-01
"Ohio","2018-11",2018,11,288000,93938,194062,101.61963460038,"11",2018-11-01
"Ohio","2018-12",2018,12,283000,85724,197276,107.004697280351,"12",2018-12-01
"Ohio","2018-02",2018,2,234000,57125,176875,121.511378273937,"02",2018-02-01
"Ohio","2018-03",2018,3,261000,68801,192199,116.554528336785,"03",2018-03-01
"Ohio","2018-04",2018,4,283000,77243,205757,114.232337616553,"04",2018-04-01
"Ohio","2018-05",2018,5,295000,109155,185845,91.9671908055078,"05",2018-05-01
"Ohio","2018-06",2018,6,3e+05,76667,223333,118.583788863904,"06",2018-06-01
"Ohio","2018-07",2018,7,293000,98909,194091,99.049013929254,"07",2018-07-01
"Ohio","2018-08",2018,8,294000,89729,204271,106.466282193944,"08",2018-08-01
"Ohio","2018-09",2018,9,286000,88430,197570,105.531073898993,"09",2018-09-01
"Ohio","2019-01",2019,1,281000,81431,199569,110.127996777318,"01",2019-01-01
"Ohio","2019-10",2019,10,278000,111844,166156,85.2423020490247,"10",2019-10-01
"Ohio","2019-11",2019,11,271000,111950,159050,83.0656743700222,"11",2019-11-01
"Ohio","2019-12",2019,12,252000,96472,155528,89.2628389081476,"12",2019-12-01
"Ohio","2019-02",2019,2,267000,75029,191971,112.254224057024,"02",2019-02-01
"Ohio","2019-03",2019,3,277000,103981,173019,90.8281515351159,"03",2019-03-01
"Ohio","2019-04",2019,4,285000,89424,195576,104.467662329338,"04",2019-04-01
"Ohio","2019-05",2019,5,295000,116305,178695,86.8917226875433,"05",2019-05-01
"Ohio","2019-06",2019,6,283000,94107,188893,100.180054997653,"06",2019-06-01
"Ohio","2019-07",2019,7,275000,87268,187732,103.642607130633,"07",2019-07-01
"Ohio","2019-08",2019,8,272000,103894,168106,89.4433005049296,"08",2019-08-01
"Ohio","2019-09",2019,9,276000,112595,163405,84.1004130264157,"09",2019-09-01
"Oklahoma","2010-01",2010,1,30000,3428,26572,158.980495393084,"01",2010-01-01
"Oklahoma","2010-10",2010,10,40000,14666,25334,92.6864961767826,"10",2010-10-01
"Oklahoma","2010-11",2010,11,37000,15354,21646,82.6909118691981,"11",2010-11-01
"Oklahoma","2010-12",2010,12,34000,14725,19275,79.1174961518728,"12",2010-12-01
"Oklahoma","2010-02",2010,2,30000,6086,23914,132.538934766946,"02",2010-02-01
"Oklahoma","2010-03",2010,3,31000,9591,21409,105.486437880318,"03",2010-03-01
"Oklahoma","2010-04",2010,4,31000,9289,21711,107.776316116061,"04",2010-04-01
"Oklahoma","2010-05",2010,5,32000,13266,18734,82.7729421640967,"05",2010-05-01
"Oklahoma","2010-06",2010,6,33000,9848,23152,108.06572068708,"06",2010-06-01
"Oklahoma","2010-07",2010,7,33000,17447,15553,61.660752869348,"07",2010-07-01
"Oklahoma","2010-08",2010,8,35000,14957,20043,80.241007266249,"08",2010-08-01
"Oklahoma","2010-09",2010,9,38000,12757,25243,99.4660834958725,"09",2010-09-01
"Oklahoma","2011-01",2011,1,32000,10247,21753,102.98009326106,"01",2011-01-01
"Oklahoma","2011-10",2011,10,49000,11766,37234,122.548793733338,"10",2011-10-01
"Oklahoma","2011-11",2011,11,45000,8990,36010,133.395073161697,"11",2011-11-01
"Oklahoma","2011-12",2011,12,45000,11539,33461,118.364314897681,"12",2011-12-01
"Oklahoma","2011-02",2011,2,33000,9962,23038,107.248265909408,"02",2011-02-01
"Oklahoma","2011-03",2011,3,36000,14099,21901,87.4308868440488,"03",2011-03-01
"Oklahoma","2011-04",2011,4,38000,11395,26605,107.72345379087,"04",2011-04-01
"Oklahoma","2011-05",2011,5,43000,12793,30207,108.282401018049,"05",2011-05-01
"Oklahoma","2011-06",2011,6,43000,10495,32505,121.525376203383,"06",2011-06-01
"Oklahoma","2011-07",2011,7,46000,12602,33398,113.982457936589,"07",2011-07-01
"Oklahoma","2011-08",2011,8,47000,13266,33734,111.950353433113,"08",2011-08-01
"Oklahoma","2011-09",2011,9,48000,10449,37551,128.491505414977,"09",2011-09-01
"Oklahoma","2012-01",2012,1,46000,12492,33508,114.572933050674,"01",2012-01-01
"Oklahoma","2012-10",2012,10,56000,9985,46015,139.471091914829,"10",2012-10-01
"Oklahoma","2012-11",2012,11,52000,9529,42471,138.051975491232,"11",2012-11-01
"Oklahoma","2012-12",2012,12,49000,12253,36747,119.984327298255,"12",2012-12-01
"Oklahoma","2012-02",2012,2,49000,12849,36151,116.900839140487,"02",2012-02-01
"Oklahoma","2012-03",2012,3,52000,14981,37019,110.535823591765,"03",2012-03-01
"Oklahoma","2012-04",2012,4,52000,10265,41735,134.056050750823,"04",2012-04-01
"Oklahoma","2012-05",2012,5,55000,11256,43744,132.045399661917,"05",2012-05-01
"Oklahoma","2012-06",2012,6,55000,10634,44366,135.192126032239,"06",2012-06-01
"Oklahoma","2012-07",2012,7,60000,11061,48939,137.737999746696,"07",2012-07-01
"Oklahoma","2012-08",2012,8,60000,8971,51029,147.972336199272,"08",2012-08-01
"Oklahoma","2012-09",2012,9,60000,9096,50904,147.342827370615,"09",2012-09-01
"Oklahoma","2013-01",2013,1,48000,15757,32243,101.143403861537,"01",2013-01-01
"Oklahoma","2013-10",2013,10,54000,23394,30606,79.0914024342972,"10",2013-10-01
"Oklahoma","2013-11",2013,11,57000,16973,40027,108.220566963622,"11",2013-11-01
"Oklahoma","2013-12",2013,12,55000,15964,39036,110.016346316442,"12",2013-12-01
"Oklahoma","2013-02",2013,2,54000,13826,40174,118.461946746086,"02",2013-02-01
"Oklahoma","2013-03",2013,3,56000,16378,39622,109.486307994142,"03",2013-03-01
"Oklahoma","2013-04",2013,4,59000,10793,48207,138.142793689912,"04",2013-04-01
"Oklahoma","2013-05",2013,5,61000,11850,49150,134.93479752917,"05",2013-05-01
"Oklahoma","2013-06",2013,6,59000,14924,44076,119.246794004653,"06",2013-06-01
"Oklahoma","2013-07",2013,7,55000,18943,36057,97.5264730941401,"07",2013-07-01
"Oklahoma","2013-08",2013,8,48000,21676,26324,75.5611688386245,"08",2013-08-01
"Oklahoma","2013-09",2013,9,49000,21224,27776,79.1068580542265,"09",2013-09-01
"Oklahoma","2014-01",2014,1,53000,19349,33651,93.0240915562067,"01",2014-01-01
"Oklahoma","2014-10",2014,10,71000,15674,55326,127.664582227658,"10",2014-10-01
"Oklahoma","2014-11",2014,11,70000,12910,57090,137.715595223737,"11",2014-11-01
"Oklahoma","2014-12",2014,12,70000,12249,57751,140.429670877457,"12",2014-12-01
"Oklahoma","2014-02",2014,2,55000,17394,37606,103.892587783518,"02",2014-02-01
"Oklahoma","2014-03",2014,3,59000,19094,39906,102.199912925449,"03",2014-03-01
"Oklahoma","2014-04",2014,4,62000,19728,42272,103.445575567737,"04",2014-04-01
"Oklahoma","2014-05",2014,5,65000,16764,48236,117.988356734015,"05",2014-05-01
"Oklahoma","2014-06",2014,6,68000,13196,54804,134.991871520765,"06",2014-06-01
"Oklahoma","2014-07",2014,7,68000,10996,57004,144.321231454757,"07",2014-07-01
"Oklahoma","2014-08",2014,8,69000,16652,52348,122.234156820623,"08",2014-08-01
"Oklahoma","2014-09",2014,9,70000,16547,53453,123.523634556946,"09",2014-09-01
"Oklahoma","2015-01",2015,1,68000,13879,54121,132.197510961297,"01",2015-01-01
"Oklahoma","2015-10",2015,10,67000,16421,50579,121.262032341976,"10",2015-10-01
"Oklahoma","2015-11",2015,11,66000,12988,53012,134.227983997569,"11",2015-11-01
"Oklahoma","2015-12",2015,12,65000,11936,53064,137.94322553811,"12",2015-12-01
"Oklahoma","2015-02",2015,2,66000,10754,55246,143.956015321677,"02",2015-02-01
"Oklahoma","2015-03",2015,3,64000,12713,51287,133.711365739835,"03",2015-03-01
"Oklahoma","2015-04",2015,4,71000,14884,56116,130.678589725676,"04",2015-04-01
"Oklahoma","2015-05",2015,5,73000,16522,56478,126.176805701392,"05",2015-05-01
"Oklahoma","2015-06",2015,6,74000,15101,58899,132.207270401006,"06",2015-06-01
"Oklahoma","2015-07",2015,7,72000,16660,55340,124.836453868712,"07",2015-07-01
"Oklahoma","2015-08",2015,8,71000,17601,53399,120.538142910351,"08",2015-08-01
"Oklahoma","2015-09",2015,9,70000,14518,55482,131.290376014577,"09",2015-09-01
"Oklahoma","2016-01",2016,1,68000,15096,52904,127.332242225859,"01",2016-01-01
"Oklahoma","2016-10",2016,10,62000,22274,39726,94.2781878159337,"10",2016-10-01
"Oklahoma","2016-11",2016,11,62000,17162,44838,113.281625022107,"11",2016-11-01
"Oklahoma","2016-12",2016,12,60000,14371,45629,122.706431270253,"12",2016-12-01
"Oklahoma","2016-02",2016,2,69000,14417,54583,130.867808720045,"02",2016-02-01
"Oklahoma","2016-03",2016,3,68000,20347,47653,107.876894518207,"03",2016-03-01
"Oklahoma","2016-04",2016,4,62000,16373,45627,116.435507126179,"04",2016-04-01
"Oklahoma","2016-05",2016,5,59000,18994,40006,102.587378516296,"05",2016-05-01
"Oklahoma","2016-06",2016,6,59000,19117,39883,102.110936159863,"06",2016-06-01
"Oklahoma","2016-07",2016,7,59000,21324,37676,93.8100692196604,"07",2016-07-01
"Oklahoma","2016-08",2016,8,61000,18027,42973,108.755235552406,"08",2016-08-01
"Oklahoma","2016-09",2016,9,63000,24615,38385,87.6219825372368,"09",2016-09-01
"Oklahoma","2017-01",2017,1,61000,16418,44582,115.172182179855,"01",2017-01-01
"Oklahoma","2017-10",2017,10,70000,13973,56027,133.440510640325,"10",2017-10-01
"Oklahoma","2017-11",2017,11,67000,13844,53156,131.502647073376,"11",2017-11-01
"Oklahoma","2017-12",2017,12,62000,11287,50713,138.395622688881,"12",2017-12-01
"Oklahoma","2017-02",2017,2,61000,16347,44653,115.461491719136,"02",2017-02-01
"Oklahoma","2017-03",2017,3,62000,21727,40273,96.2007476680163,"03",2017-03-01
"Oklahoma","2017-04",2017,4,65000,16949,48051,117.270497504546,"04",2017-04-01
"Oklahoma","2017-05",2017,5,64000,17471,46529,114.222238587964,"05",2017-05-01
"Oklahoma","2017-06",2017,6,68000,18369,49631,114.927809746553,"06",2017-06-01
"Oklahoma","2017-07",2017,7,69000,19759,49241,110.95438209083,"07",2017-07-01
"Oklahoma","2017-08",2017,8,73000,18144,54856,120.372158342842,"08",2017-08-01
"Oklahoma","2017-09",2017,9,73000,14937,58063,132.055903658301,"09",2017-09-01
"Oklahoma","2018-01",2018,1,64000,15448,48552,122.223341053268,"01",2018-01-01
"Oklahoma","2018-10",2018,10,85000,33235,51765,87.5629043853343,"10",2018-10-01
"Oklahoma","2018-11",2018,11,84000,29252,54748,96.6835022781055,"11",2018-11-01
"Oklahoma","2018-12",2018,12,82000,27067,54933,100.732577223175,"12",2018-12-01
"Oklahoma","2018-02",2018,2,66000,16425,49575,120.291173794358,"02",2018-02-01
"Oklahoma","2018-03",2018,3,68000,22457,45543,100.695358015411,"03",2018-03-01
"Oklahoma","2018-04",2018,4,70000,52218,17782,29.0988234138998,"04",2018-04-01
"Oklahoma","2018-05",2018,5,75000,46842,28158,46.2205150933176,"05",2018-05-01
"Oklahoma","2018-06",2018,6,79000,29585,49415,91.016254547129,"06",2018-06-01
"Oklahoma","2018-07",2018,7,82000,32992,49008,85.2372338945318,"07",2018-07-01
"Oklahoma","2018-08",2018,8,83000,28344,54656,98.1750251472913,"08",2018-08-01
"Oklahoma","2018-09",2018,9,85000,27353,57647,102.617642608564,"09",2018-09-01
"Oklahoma","2019-01",2019,1,82000,24103,57897,109.133577749922,"01",2019-01-01
"Oklahoma","2019-10",2019,10,90000,35425,54575,87.0241179988041,"10",2019-10-01
"Oklahoma","2019-11",2019,11,82000,36591,45409,76.5808535217681,"11",2019-11-01
"Oklahoma","2019-12",2019,12,76000,27846,48154,92.7411744313695,"12",2019-12-01
"Oklahoma","2019-02",2019,2,80000,26082,53918,101.653437906525,"02",2019-02-01
"Oklahoma","2019-03",2019,3,83000,32384,50616,87.7348679192956,"03",2019-03-01
"Oklahoma","2019-04",2019,4,81000,28233,52767,96.6136607069292,"04",2019-04-01
"Oklahoma","2019-05",2019,5,85000,36463,48537,79.9206342672254,"05",2019-05-01
"Oklahoma","2019-06",2019,6,83000,26520,56480,103.140978816654,"06",2019-06-01
"Oklahoma","2019-07",2019,7,83000,25533,57467,105.897745386196,"07",2019-07-01
"Oklahoma","2019-08",2019,8,85000,31946,53054,90.7324748174371,"08",2019-08-01
"Oklahoma","2019-09",2019,9,85000,33499,51501,86.92225250846,"09",2019-09-01
"Oregon","2010-01",2010,1,31000,5944,25056,135.643135556518,"01",2010-01-01
"Oregon","2010-10",2010,10,40000,17657,22343,77.5031652704789,"10",2010-10-01
"Oregon","2010-11",2010,11,39000,14224,24776,93.1008567563505,"11",2010-11-01
"Oregon","2010-12",2010,12,37000,22720,14280,47.8231748158071,"12",2010-12-01
"Oregon","2010-02",2010,2,34000,13202,20798,88.1233846023474,"02",2010-02-01
"Oregon","2010-03",2010,3,36000,15254,20746,80.9536816638701,"03",2010-03-01
"Oregon","2010-04",2010,4,39000,15209,23791,87.7750926967847,"04",2010-04-01
"Oregon","2010-05",2010,5,39000,19177,19823,68.1472059404919,"05",2010-05-01
"Oregon","2010-06",2010,6,39000,18162,20838,72.9085756271649,"06",2010-06-01
"Oregon","2010-07",2010,7,38000,18838,19162,67.42672155952,"07",2010-07-01
"Oregon","2010-08",2010,8,39000,18101,20899,73.2001190872314,"08",2010-08-01
"Oregon","2010-09",2010,9,41000,15484,25516,90.3477090857588,"09",2010-09-01
"Oregon","2011-01",2011,1,34000,17381,16619,64.6892820303225,"01",2011-01-01
"Oregon","2011-10",2011,10,48000,21613,26387,75.8105526266646,"10",2011-10-01
"Oregon","2011-11",2011,11,46000,20437,25563,76.9541068982645,"11",2011-11-01
"Oregon","2011-12",2011,12,39000,18133,20867,73.0471006248578,"12",2011-12-01
"Oregon","2011-02",2011,2,34000,17980,16020,61.6390919584456,"02",2011-02-01
"Oregon","2011-03",2011,3,36000,21719,14281,49.4845718047783,"03",2011-03-01
"Oregon","2011-04",2011,4,40000,15291,24709,89.3780181222984,"04",2011-04-01
"Oregon","2011-05",2011,5,42000,22058,19942,62.2623247681788,"05",2011-05-01
"Oregon","2011-06",2011,6,44000,24619,19381,56.4887276118859,"06",2011-06-01
"Oregon","2011-07",2011,7,44000,23130,20870,62.1778638462684,"07",2011-07-01
"Oregon","2011-08",2011,8,44000,22895,21105,63.0988863143733,"08",2011-08-01
"Oregon","2011-09",2011,9,48000,23272,24728,69.3905039847345,"09",2011-09-01
"Oregon","2012-01",2012,1,36000,16285,19715,75.4135985464282,"01",2012-01-01
"Oregon","2012-10",2012,10,41000,18396,22604,76.1128695535053,"10",2012-10-01
"Oregon","2012-11",2012,11,41000,16323,24677,86.0980758159901,"11",2012-11-01
"Oregon","2012-12",2012,12,39000,17623,21377,75.5064196527913,"12",2012-12-01
"Oregon","2012-02",2012,2,37000,17707,19293,70.5321074085583,"02",2012-02-01
"Oregon","2012-03",2012,3,39000,17522,21478,75.9987261597254,"03",2012-03-01
"Oregon","2012-04",2012,4,42000,16245,25755,88.4367756889003,"04",2012-04-01
"Oregon","2012-05",2012,5,49000,17335,31665,95.4699630662546,"05",2012-05-01
"Oregon","2012-06",2012,6,52000,15916,36084,106.260674951411,"06",2012-06-01
"Oregon","2012-07",2012,7,51000,14945,36055,109.348699673971,"07",2012-07-01
"Oregon","2012-08",2012,8,45000,19000,26000,81.25,"08",2012-08-01
"Oregon","2012-09",2012,9,43000,17616,25384,83.7534644318332,"09",2012-09-01
"Oregon","2013-01",2013,1,41000,23884,17116,52.7587694963319,"01",2013-01-01
"Oregon","2013-10",2013,10,52000,31185,20815,50.0450802428322,"10",2013-10-01
"Oregon","2013-11",2013,11,52000,22777,29223,78.1603969134894,"11",2013-11-01
"Oregon","2013-12",2013,12,47000,18476,28524,87.1281080090415,"12",2013-12-01
"Oregon","2013-02",2013,2,43000,20380,22620,71.3789839065951,"02",2013-02-01
"Oregon","2013-03",2013,3,48000,18552,29448,88.496213487198,"03",2013-03-01
"Oregon","2013-04",2013,4,51000,19699,31301,88.5472213185476,"04",2013-04-01
"Oregon","2013-05",2013,5,54000,13651,40349,119.285745960887,"05",2013-05-01
"Oregon","2013-06",2013,6,50000,18848,31152,90.49500348594,"06",2013-06-01
"Oregon","2013-07",2013,7,49000,23810,25190,69.19379206153,"07",2013-07-01
"Oregon","2013-08",2013,8,48000,20286,27714,81.1703716720851,"08",2013-08-01
"Oregon","2013-09",2013,9,52000,28530,23470,58.2888364584627,"09",2013-09-01
"Oregon","2014-01",2014,1,49000,22401,26599,74.5059593002899,"01",2014-01-01
"Oregon","2014-10",2014,10,68000,18756,49244,113.522984001107,"10",2014-10-01
"Oregon","2014-11",2014,11,63000,19594,43406,105.106908492142,"11",2014-11-01
"Oregon","2014-12",2014,12,59000,18180,40820,105.778699144856,"12",2014-12-01
"Oregon","2014-02",2014,2,52000,21599,30401,82.6125354964062,"02",2014-02-01
"Oregon","2014-03",2014,3,57000,20565,36435,93.9470121833301,"03",2014-03-01
"Oregon","2014-04",2014,4,58000,23475,34525,84.7499232893526,"04",2014-04-01
"Oregon","2014-05",2014,5,59000,20951,38049,95.1807982389213,"05",2014-05-01
"Oregon","2014-06",2014,6,59000,18727,40273,103.626796351332,"06",2014-06-01
"Oregon","2014-07",2014,7,61000,13893,47107,125.798138677847,"07",2014-07-01
"Oregon","2014-08",2014,8,64000,16874,47126,116.541781042115,"08",2014-08-01
"Oregon","2014-09",2014,9,69000,16648,52352,122.249206052681,"09",2014-09-01
"Oregon","2015-01",2015,1,59000,16724,42276,111.658126881834,"01",2015-01-01
"Oregon","2015-10",2015,10,74000,42361,31639,54.3807633141688,"10",2015-10-01
"Oregon","2015-11",2015,11,75000,33805,41195,75.7226230412205,"11",2015-11-01
"Oregon","2015-12",2015,12,69000,30742,38258,76.7139219185499,"12",2015-12-01
"Oregon","2015-02",2015,2,62000,13428,48572,128.790369624012,"02",2015-02-01
"Oregon","2015-03",2015,3,64000,20428,43572,103.216942246648,"03",2015-03-01
"Oregon","2015-04",2015,4,69000,37719,31281,58.6231130351671,"04",2015-04-01
"Oregon","2015-05",2015,5,68000,48799,19201,32.8787061533061,"05",2015-05-01
"Oregon","2015-06",2015,6,69000,48983,20017,33.932007153573,"06",2015-06-01
"Oregon","2015-07",2015,7,71000,50943,20057,32.8956971699893,"07",2015-07-01
"Oregon","2015-08",2015,8,72000,57857,14143,21.7824222028847,"08",2015-08-01
"Oregon","2015-09",2015,9,75000,43073,31927,54.0801029871351,"09",2015-09-01
"Oregon","2016-01",2016,1,65000,39300,25700,49.28092042186,"01",2016-01-01
"Oregon","2016-10",2016,10,78000,38942,39058,66.798925963298,"10",2016-10-01
"Oregon","2016-11",2016,11,75000,33511,41489,76.4696666697386,"11",2016-11-01
"Oregon","2016-12",2016,12,68000,29581,38419,78.7427880427542,"12",2016-12-01
"Oregon","2016-02",2016,2,65000,32070,32930,67.847944782116,"02",2016-02-01
"Oregon","2016-03",2016,3,70000,34698,35302,67.4358631492483,"03",2016-03-01
"Oregon","2016-04",2016,4,78000,37338,40662,70.5092857514436,"04",2016-04-01
"Oregon","2016-05",2016,5,84000,34145,49855,84.3962926911846,"05",2016-05-01
"Oregon","2016-06",2016,6,82000,39956,42044,68.9494571812785,"06",2016-06-01
"Oregon","2016-07",2016,7,82000,43777,38223,60.7789977499861,"07",2016-07-01
"Oregon","2016-08",2016,8,81000,35488,45512,78.1402376210425,"08",2016-08-01
"Oregon","2016-09",2016,9,84000,42881,41119,64.8150629329844,"09",2016-09-01
"Oregon","2017-01",2017,1,66000,32318,33682,68.5164466323562,"01",2017-01-01
"Oregon","2017-10",2017,10,94000,27540,66460,109.363172618068,"10",2017-10-01
"Oregon","2017-11",2017,11,90000,25474,64526,111.758491088903,"11",2017-11-01
"Oregon","2017-12",2017,12,81000,20044,60956,120.652389058232,"12",2017-12-01
"Oregon","2017-02",2017,2,65000,35761,29239,58.0363434265241,"02",2017-02-01
"Oregon","2017-03",2017,3,68000,35505,32495,62.7892372349162,"03",2017-03-01
"Oregon","2017-04",2017,4,74000,32084,41916,79.024169526036,"04",2017-04-01
"Oregon","2017-05",2017,5,75000,36863,38137,68.1851908137633,"05",2017-05-01
"Oregon","2017-06",2017,6,83000,36981,46019,76.7104791592002,"06",2017-06-01
"Oregon","2017-07",2017,7,89000,34981,54019,87.1407715698373,"07",2017-07-01
"Oregon","2017-08",2017,8,96000,31759,64241,100.565909251012,"08",2017-08-01
"Oregon","2017-09",2017,9,97000,30134,66866,105.189799738858,"09",2017-09-01
"Oregon","2018-01",2018,1,78000,25328,52672,101.951068442242,"01",2018-01-01
"Oregon","2018-10",2018,10,109000,42023,66977,88.6977480251353,"10",2018-10-01
"Oregon","2018-11",2018,11,104000,42995,61005,83.0028232252798,"11",2018-11-01
"Oregon","2018-12",2018,12,96000,34460,61540,94.3430936685574,"12",2018-12-01
"Oregon","2018-02",2018,2,79000,25375,53625,102.754491017964,"02",2018-02-01
"Oregon","2018-03",2018,3,81000,33725,47275,82.4144693833079,"03",2018-03-01
"Oregon","2018-04",2018,4,81000,32842,48158,84.6049788303087,"04",2018-04-01
"Oregon","2018-05",2018,5,84000,44913,39087,60.6408973493752,"05",2018-05-01
"Oregon","2018-06",2018,6,89000,33813,55187,89.871593398093,"06",2018-06-01
"Oregon","2018-07",2018,7,98000,46021,51979,72.1825289367523,"07",2018-07-01
"Oregon","2018-08",2018,8,104000,40647,63353,87.5967009339979,"08",2018-08-01
"Oregon","2018-09",2018,9,109000,34181,74819,104.509676563231,"09",2018-09-01
"Oregon","2019-01",2019,1,94000,38233,55767,84.3465700694985,"01",2019-01-01
"Oregon","2019-10",2019,10,102000,43796,58204,79.8430683969382,"10",2019-10-01
"Oregon","2019-11",2019,11,1e+05,44147,55853,77.4945021401764,"11",2019-11-01
"Oregon","2019-12",2019,12,94000,36001,57999,89.2285443958123,"12",2019-12-01
"Oregon","2019-02",2019,2,93000,35140,57860,90.3074761979085,"02",2019-02-01
"Oregon","2019-03",2019,3,94000,37727,56273,85.4388242349708,"03",2019-03-01
"Oregon","2019-04",2019,4,93000,35214,57786,90.1399223173756,"04",2019-04-01
"Oregon","2019-05",2019,5,94000,44137,49863,72.1935469859632,"05",2019-05-01
"Oregon","2019-06",2019,6,98000,34349,63651,96.1865975564606,"06",2019-06-01
"Oregon","2019-07",2019,7,102000,32504,69496,103.336703741153,"07",2019-07-01
"Oregon","2019-08",2019,8,104000,44567,59433,80.0083464026332,"08",2019-08-01
"Oregon","2019-09",2019,9,104000,43384,60616,82.2558758074146,"09",2019-09-01
"Pennsylvania","2010-01",2010,1,115000,19086,95914,143.063407067106,"01",2010-01-01
"Pennsylvania","2010-10",2010,10,164000,49947,114053,106.617994176128,"10",2010-10-01
"Pennsylvania","2010-11",2010,11,162000,49709,112291,106.080516180229,"11",2010-11-01
"Pennsylvania","2010-12",2010,12,154000,48720,105280,103.867403314917,"12",2010-12-01
"Pennsylvania","2010-02",2010,2,118000,34360,83640,109.792596482016,"02",2010-02-01
"Pennsylvania","2010-03",2010,3,126000,44583,81417,95.4573433460544,"03",2010-03-01
"Pennsylvania","2010-04",2010,4,142000,47672,94328,99.4643384368805,"04",2010-04-01
"Pennsylvania","2010-05",2010,5,150000,51198,98802,98.2136999373751,"05",2010-05-01
"Pennsylvania","2010-06",2010,6,149000,50348,98652,98.9746573830688,"06",2010-06-01
"Pennsylvania","2010-07",2010,7,140000,48567,91433,96.9766714218288,"07",2010-07-01
"Pennsylvania","2010-08",2010,8,148000,60131,87869,84.4362444806396,"08",2010-08-01
"Pennsylvania","2010-09",2010,9,155000,47728,107272,105.828499269958,"09",2010-09-01
"Pennsylvania","2011-01",2011,1,151000,64350,86650,80.4736475504992,"01",2011-01-01
"Pennsylvania","2011-10",2011,10,168000,43641,124359,117.518817242406,"10",2011-10-01
"Pennsylvania","2011-11",2011,11,168000,39214,128786,124.302411999189,"11",2011-11-01
"Pennsylvania","2011-12",2011,12,157000,42183,114817,115.287951280983,"12",2011-12-01
"Pennsylvania","2011-02",2011,2,151000,48354,102646,102.978620945654,"02",2011-02-01
"Pennsylvania","2011-03",2011,3,161000,56192,104808,96.5118420567977,"03",2011-03-01
"Pennsylvania","2011-04",2011,4,163000,46187,116813,111.682848360558,"04",2011-04-01
"Pennsylvania","2011-05",2011,5,164000,59279,104721,93.8028206862267,"05",2011-05-01
"Pennsylvania","2011-06",2011,6,161000,46688,114312,110.080505373445,"06",2011-06-01
"Pennsylvania","2011-07",2011,7,160000,50305,109695,104.319916312023,"07",2011-07-01
"Pennsylvania","2011-08",2011,8,158000,49601,108399,104.430132802829,"08",2011-08-01
"Pennsylvania","2011-09",2011,9,162000,46244,115756,111.173431167285,"09",2011-09-01
"Pennsylvania","2012-01",2012,1,152000,48855,103145,102.705932140101,"01",2012-01-01
"Pennsylvania","2012-10",2012,10,189000,43395,145605,125.308203704899,"10",2012-10-01
"Pennsylvania","2012-11",2012,11,183000,37456,145544,132.039046340313,"11",2012-11-01
"Pennsylvania","2012-12",2012,12,176000,43699,132301,120.438418017378,"12",2012-12-01
"Pennsylvania","2012-02",2012,2,154000,52616,101384,98.137607929686,"02",2012-02-01
"Pennsylvania","2012-03",2012,3,167000,50221,116779,107.520911882369,"03",2012-03-01
"Pennsylvania","2012-04",2012,4,181000,45047,135953,120.287373864727,"04",2012-04-01
"Pennsylvania","2012-05",2012,5,188000,45716,142284,121.758031114686,"05",2012-05-01
"Pennsylvania","2012-06",2012,6,190000,41469,148531,128.337703968998,"06",2012-06-01
"Pennsylvania","2012-07",2012,7,180000,40682,139318,126.26131718944,"07",2012-07-01
"Pennsylvania","2012-08",2012,8,182000,36801,145199,132.722428142467,"08",2012-08-01
"Pennsylvania","2012-09",2012,9,181000,39561,141439,128.253861743463,"09",2012-09-01
"Pennsylvania","2013-01",2013,1,162000,65164,96836,85.2564666936663,"01",2013-01-01
"Pennsylvania","2013-10",2013,10,167000,55250,111750,100.562429696288,"10",2013-10-01
"Pennsylvania","2013-11",2013,11,163000,48881,114119,107.719899377481,"11",2013-11-01
"Pennsylvania","2013-12",2013,12,154000,51522,102478,99.7246036920622,"12",2013-12-01
"Pennsylvania","2013-02",2013,2,155000,48869,106131,104.116859355763,"02",2013-02-01
"Pennsylvania","2013-03",2013,3,153000,46863,106137,106.209753681272,"03",2013-03-01
"Pennsylvania","2013-04",2013,4,151000,41702,109298,113.437328102459,"04",2013-04-01
"Pennsylvania","2013-05",2013,5,155000,40170,114830,117.671773325819,"05",2013-05-01
"Pennsylvania","2013-06",2013,6,159000,44974,114026,111.804445664644,"06",2013-06-01
"Pennsylvania","2013-07",2013,7,157000,70602,86398,75.9202467465137,"07",2013-07-01
"Pennsylvania","2013-08",2013,8,158000,57403,100597,93.4035273417733,"08",2013-08-01
"Pennsylvania","2013-09",2013,9,164000,57373,106627,96.3324343980522,"09",2013-09-01
"Pennsylvania","2014-01",2014,1,153000,56933,96067,91.5215806947931,"01",2014-01-01
"Pennsylvania","2014-10",2014,10,211000,51159,159841,121.942027548167,"10",2014-10-01
"Pennsylvania","2014-11",2014,11,199000,44736,154264,126.582860143762,"11",2014-11-01
"Pennsylvania","2014-12",2014,12,203000,43728,159272,129.107357089589,"12",2014-12-01
"Pennsylvania","2014-02",2014,2,153000,49689,103311,101.940411171795,"02",2014-02-01
"Pennsylvania","2014-03",2014,3,155000,62153,92847,85.5129793279393,"03",2014-03-01
"Pennsylvania","2014-04",2014,4,166000,56311,109689,98.6806770695107,"04",2014-04-01
"Pennsylvania","2014-05",2014,5,173000,54061,118939,104.76391806607,"05",2014-05-01
"Pennsylvania","2014-06",2014,6,189000,47366,141634,119.8429554166,"06",2014-06-01
"Pennsylvania","2014-07",2014,7,2e+05,44100,155900,127.734535026628,"07",2014-07-01
"Pennsylvania","2014-08",2014,8,213000,51261,161739,122.408527932612,"08",2014-08-01
"Pennsylvania","2014-09",2014,9,216000,53323,162677,120.804387297037,"09",2014-09-01
"Pennsylvania","2015-01",2015,1,199000,48638,150362,121.436936172962,"01",2015-01-01
"Pennsylvania","2015-10",2015,10,248000,70995,177005,110.976661076192,"10",2015-10-01
"Pennsylvania","2015-11",2015,11,233000,57802,175198,120.492981478807,"11",2015-11-01
"Pennsylvania","2015-12",2015,12,222000,54868,167132,120.730456390771,"12",2015-12-01
"Pennsylvania","2015-02",2015,2,215000,40131,174869,137.081734481502,"02",2015-02-01
"Pennsylvania","2015-03",2015,3,214000,50138,163862,124.073022435242,"03",2015-03-01
"Pennsylvania","2015-04",2015,4,234000,55582,178418,123.224509810693,"04",2015-04-01
"Pennsylvania","2015-05",2015,5,240000,61244,178756,118.678546294698,"05",2015-05-01
"Pennsylvania","2015-06",2015,6,237000,60721,176279,118.418922413938,"06",2015-06-01
"Pennsylvania","2015-07",2015,7,234000,71244,162756,106.639933954476,"07",2015-07-01
"Pennsylvania","2015-08",2015,8,243000,68997,174003,111.541457129395,"08",2015-08-01
"Pennsylvania","2015-09",2015,9,252000,62892,189108,120.109751914942,"09",2015-09-01
"Pennsylvania","2016-01",2016,1,212000,70999,141001,99.6477019353425,"01",2016-01-01
"Pennsylvania","2016-10",2016,10,246000,84788,161212,97.4714923153198,"10",2016-10-01
"Pennsylvania","2016-11",2016,11,242000,72819,169181,107.478265288944,"11",2016-11-01
"Pennsylvania","2016-12",2016,12,231000,67661,163339,109.380869949541,"12",2016-12-01
"Pennsylvania","2016-02",2016,2,203000,63888,139112,104.247474596085,"02",2016-02-01
"Pennsylvania","2016-03",2016,3,205000,84055,120945,83.6830361003961,"03",2016-03-01
"Pennsylvania","2016-04",2016,4,207000,73487,133513,95.200847098083,"04",2016-04-01
"Pennsylvania","2016-05",2016,5,203000,64725,138275,103.2962928378,"05",2016-05-01
"Pennsylvania","2016-06",2016,6,195000,74604,120396,89.3132149374638,"06",2016-06-01
"Pennsylvania","2016-07",2016,7,2e+05,83226,116774,82.4599436492412,"07",2016-07-01
"Pennsylvania","2016-08",2016,8,216000,77003,138997,94.8775268512609,"08",2016-08-01
"Pennsylvania","2016-09",2016,9,242000,89787,152213,91.7534442277726,"09",2016-09-01
"Pennsylvania","2017-01",2017,1,227000,75803,151197,99.8649286830051,"01",2017-01-01
"Pennsylvania","2017-10",2017,10,299000,66494,232506,127.228353953827,"10",2017-10-01
"Pennsylvania","2017-11",2017,11,278000,61897,216103,127.157933138568,"11",2017-11-01
"Pennsylvania","2017-12",2017,12,263000,49930,213070,136.177419870259,"12",2017-12-01
"Pennsylvania","2017-02",2017,2,243000,77357,165643,103.411506538019,"02",2017-02-01
"Pennsylvania","2017-03",2017,3,256000,96454,159546,90.534367605418,"03",2017-03-01
"Pennsylvania","2017-04",2017,4,275000,91104,183896,100.461071171033,"04",2017-04-01
"Pennsylvania","2017-05",2017,5,269000,84563,184437,104.330487070197,"05",2017-05-01
"Pennsylvania","2017-06",2017,6,262000,80695,181305,105.811289922526,"06",2017-06-01
"Pennsylvania","2017-07",2017,7,258000,77185,180815,107.889672867223,"07",2017-07-01
"Pennsylvania","2017-08",2017,8,279000,77603,201397,112.953059845262,"08",2017-08-01
"Pennsylvania","2017-09",2017,9,296000,65461,230539,127.55954307657,"09",2017-09-01
"Pennsylvania","2018-01",2018,1,252000,64366,187634,118.618309173552,"01",2018-01-01
"Pennsylvania","2018-10",2018,10,313000,101450,211550,102.087103390035,"10",2018-10-01
"Pennsylvania","2018-11",2018,11,312000,86698,225302,113.018876442821,"11",2018-11-01
"Pennsylvania","2018-12",2018,12,308000,82118,225882,115.801885583336,"12",2018-12-01
"Pennsylvania","2018-02",2018,2,259000,60492,198508,124.264770322888,"02",2018-02-01
"Pennsylvania","2018-03",2018,3,278000,81894,196106,108.979866293964,"03",2018-03-01
"Pennsylvania","2018-04",2018,4,290000,79857,210143,113.634729098003,"04",2018-04-01
"Pennsylvania","2018-05",2018,5,294000,111505,182495,90.0087545159739,"05",2018-05-01
"Pennsylvania","2018-06",2018,6,287000,71214,215786,120.478819923286,"06",2018-06-01
"Pennsylvania","2018-07",2018,7,293000,97064,195936,100.463513679806,"07",2018-07-01
"Pennsylvania","2018-08",2018,8,295000,91373,203627,105.404363141317,"08",2018-08-01
"Pennsylvania","2018-09",2018,9,301000,84739,216261,112.12814882602,"09",2018-09-01
"Pennsylvania","2019-01",2019,1,3e+05,84976,215024,111.707742820332,"01",2019-01-01
"Pennsylvania","2019-10",2019,10,307000,102244,204756,100.065486604568,"10",2019-10-01
"Pennsylvania","2019-11",2019,11,291000,103488,187512,95.0660096124597,"11",2019-11-01
"Pennsylvania","2019-12",2019,12,277000,91947,185053,100.314137260907,"12",2019-12-01
"Pennsylvania","2019-02",2019,2,3e+05,81300,218700,114.7128245476,"02",2019-02-01
"Pennsylvania","2019-03",2019,3,298000,99181,198819,100.115060891634,"03",2019-03-01
"Pennsylvania","2019-04",2019,4,284000,88971,195029,104.581321335975,"04",2019-04-01
"Pennsylvania","2019-05",2019,5,289000,111251,177749,88.8187662241943,"05",2019-05-01
"Pennsylvania","2019-06",2019,6,281000,86732,194268,105.657380918713,"06",2019-06-01
"Pennsylvania","2019-07",2019,7,279000,76318,202682,114.084847939029,"07",2019-07-01
"Pennsylvania","2019-08",2019,8,284000,109885,174115,88.4090534039123,"08",2019-08-01
"Pennsylvania","2019-09",2019,9,290000,113838,176162,87.2438948291146,"09",2019-09-01
"Rhode Island","2010-01",2010,1,9000,1461,7539,144.135359908231,"01",2010-01-01
"Rhode Island","2010-10",2010,10,13000,4205,8795,102.23772159256,"10",2010-10-01
"Rhode Island","2010-11",2010,11,12000,4900,7100,84.0236686390533,"11",2010-11-01
"Rhode Island","2010-12",2010,12,11000,4993,6007,75.1203651597574,"12",2010-12-01
"Rhode Island","2010-02",2010,2,10000,2135,7865,129.625051503914,"02",2010-02-01
"Rhode Island","2010-03",2010,3,11000,3220,7780,109.423347398031,"03",2010-03-01
"Rhode Island","2010-04",2010,4,13000,3728,9272,110.856049736968,"04",2010-04-01
"Rhode Island","2010-05",2010,5,13000,4639,8361,94.8012925902829,"05",2010-05-01
"Rhode Island","2010-06",2010,6,14000,5516,8484,86.9440459110473,"06",2010-06-01
"Rhode Island","2010-07",2010,7,13000,4412,8588,98.6446129106363,"07",2010-07-01
"Rhode Island","2010-08",2010,8,14000,4681,9319,99.769819602805,"08",2010-08-01
"Rhode Island","2010-09",2010,9,14000,4108,9892,109.25557764524,"09",2010-09-01
"Rhode Island","2011-01",2011,1,11000,4597,6403,82.1055331153427,"01",2011-01-01
"Rhode Island","2011-10",2011,10,13000,6877,6123,61.6088947024199,"10",2011-10-01
"Rhode Island","2011-11",2011,11,13000,6294,6706,69.5138384990152,"11",2011-11-01
"Rhode Island","2011-12",2011,12,12000,5394,6606,75.9572266298724,"12",2011-12-01
"Rhode Island","2011-02",2011,2,11000,3343,7657,106.769852889911,"02",2011-02-01
"Rhode Island","2011-03",2011,3,12000,6016,5984,66.4298401420959,"03",2011-03-01
"Rhode Island","2011-04",2011,4,13000,5082,7918,87.5788076540206,"04",2011-04-01
"Rhode Island","2011-05",2011,5,14000,11754,2246,17.4419507649297,"05",2011-05-01
"Rhode Island","2011-06",2011,6,14000,5994,8006,80.0840252075623,"06",2011-06-01
"Rhode Island","2011-07",2011,7,12000,8996,3004,28.6149742808154,"07",2011-07-01
"Rhode Island","2011-08",2011,8,13000,7747,5253,50.6386465513086,"08",2011-08-01
"Rhode Island","2011-09",2011,9,13000,6698,6302,63.986191491522,"09",2011-09-01
"Rhode Island","2012-01",2012,1,12000,5738,6262,70.6054797609652,"01",2012-01-01
"Rhode Island","2012-10",2012,10,17000,3496,13504,131.772053083528,"10",2012-10-01
"Rhode Island","2012-11",2012,11,15000,2967,12033,133.9455668726,"11",2012-11-01
"Rhode Island","2012-12",2012,12,14000,10016,3984,33.1778814123917,"12",2012-12-01
"Rhode Island","2012-02",2012,2,13000,5337,7663,83.5796477068223,"02",2012-02-01
"Rhode Island","2012-03",2012,3,14000,8349,5651,50.5704953241756,"03",2012-03-01
"Rhode Island","2012-04",2012,4,14000,7002,6998,66.6412722597848,"04",2012-04-01
"Rhode Island","2012-05",2012,5,15000,8274,6726,57.7984016499098,"05",2012-05-01
"Rhode Island","2012-06",2012,6,16000,8812,7188,57.9397065935838,"06",2012-06-01
"Rhode Island","2012-07",2012,7,15000,5899,9101,87.0950763194411,"07",2012-07-01
"Rhode Island","2012-08",2012,8,16000,7482,8518,72.5491866110212,"08",2012-08-01
"Rhode Island","2012-09",2012,9,16000,3412,12588,129.692973418504,"09",2012-09-01
"Rhode Island","2013-01",2013,1,13000,7424,5576,54.602428515472,"01",2013-01-01
"Rhode Island","2013-10",2013,10,15000,5063,9937,99.0579674026816,"10",2013-10-01
"Rhode Island","2013-11",2013,11,15000,4501,10499,107.676529408748,"11",2013-11-01
"Rhode Island","2013-12",2013,12,13000,5283,7717,84.4172181808237,"12",2013-12-01
"Rhode Island","2013-02",2013,2,13000,3856,9144,108.495491219744,"02",2013-02-01
"Rhode Island","2013-03",2013,3,13000,3667,9333,111.993760124798,"03",2013-03-01
"Rhode Island","2013-04",2013,4,14000,2653,11347,136.275746111812,"04",2013-04-01
"Rhode Island","2013-05",2013,5,15000,2679,12321,139.385711861531,"05",2013-05-01
"Rhode Island","2013-06",2013,6,15000,3040,11960,132.594235033259,"06",2013-06-01
"Rhode Island","2013-07",2013,7,14000,5278,8722,90.4865649963689,"07",2013-07-01
"Rhode Island","2013-08",2013,8,14000,4430,9570,103.852414541508,"08",2013-08-01
"Rhode Island","2013-09",2013,9,15000,4347,10653,110.125600868352,"09",2013-09-01
"Rhode Island","2014-01",2014,1,13000,6821,6179,62.3480147318501,"01",2014-01-01
"Rhode Island","2014-10",2014,10,17000,6846,10154,85.1631300847102,"10",2014-10-01
"Rhode Island","2014-11",2014,11,15000,6940,8060,73.4731084776664,"11",2014-11-01
"Rhode Island","2014-12",2014,12,15000,7062,7938,71.9608376393799,"12",2014-12-01
"Rhode Island","2014-02",2014,2,14000,6203,7797,77.1865564520121,"02",2014-02-01
"Rhode Island","2014-03",2014,3,14000,6904,7096,67.8913126674321,"03",2014-03-01
"Rhode Island","2014-04",2014,4,15000,6606,8394,77.700638711469,"04",2014-04-01
"Rhode Island","2014-05",2014,5,15000,6710,8290,76.3703362505758,"05",2014-05-01
"Rhode Island","2014-06",2014,6,16000,6078,9922,89.8813298306006,"06",2014-06-01
"Rhode Island","2014-07",2014,7,17000,4701,12299,113.349615225105,"07",2014-07-01
"Rhode Island","2014-08",2014,8,18000,7329,10671,84.2591495913775,"08",2014-08-01
"Rhode Island","2014-09",2014,9,18000,8880,9120,67.8571428571429,"09",2014-09-01
"Rhode Island","2015-01",2015,1,14000,8570,5430,48.1169694284448,"01",2015-01-01
"Rhode Island","2015-10",2015,10,19000,7625,11375,85.4460093896714,"10",2015-10-01
"Rhode Island","2015-11",2015,11,19000,7448,11552,87.3563218390805,"11",2015-11-01
"Rhode Island","2015-12",2015,12,19000,7077,11923,91.4445680101239,"12",2015-12-01
"Rhode Island","2015-02",2015,2,15000,6377,8623,80.6754923515928,"02",2015-02-01
"Rhode Island","2015-03",2015,3,15000,10578,4422,34.5765892563922,"03",2015-03-01
"Rhode Island","2015-04",2015,4,17000,7904,9096,73.048506264054,"04",2015-04-01
"Rhode Island","2015-05",2015,5,18000,8104,9896,75.8197977321483,"05",2015-05-01
"Rhode Island","2015-06",2015,6,18000,8049,9951,76.4021651502937,"06",2015-06-01
"Rhode Island","2015-07",2015,7,18000,8017,9983,76.742130145674,"07",2015-07-01
"Rhode Island","2015-08",2015,8,17000,8235,8765,69.4670101050129,"08",2015-08-01
"Rhode Island","2015-09",2015,9,19000,7002,11998,92.28520883009,"09",2015-09-01
"Rhode Island","2016-01",2016,1,18000,11575,6425,43.4488588334742,"01",2016-01-01
"Rhode Island","2016-10",2016,10,21000,6553,14447,104.866983631546,"10",2016-10-01
"Rhode Island","2016-11",2016,11,20000,5836,14164,109.645455952934,"11",2016-11-01
"Rhode Island","2016-12",2016,12,18000,6004,11996,99.9500083319447,"12",2016-12-01
"Rhode Island","2016-02",2016,2,18000,9119,8881,65.4965153582359,"02",2016-02-01
"Rhode Island","2016-03",2016,3,18000,8399,9601,72.7376036971097,"03",2016-03-01
"Rhode Island","2016-04",2016,4,19000,5847,13153,105.871936249849,"04",2016-04-01
"Rhode Island","2016-05",2016,5,19000,5810,13190,106.328093510681,"05",2016-05-01
"Rhode Island","2016-06",2016,6,19000,6391,12609,99.3186562167697,"06",2016-06-01
"Rhode Island","2016-07",2016,7,19000,6003,12997,103.963524377075,"07",2016-07-01
"Rhode Island","2016-08",2016,8,20000,5685,14315,111.465836091104,"08",2016-08-01
"Rhode Island","2016-09",2016,9,21000,6861,14139,101.496715839345,"09",2016-09-01
"Rhode Island","2017-01",2017,1,18000,6234,11766,97.1032433770735,"01",2017-01-01
"Rhode Island","2017-10",2017,10,22000,5713,16287,117.540504456392,"10",2017-10-01
"Rhode Island","2017-11",2017,11,21000,5668,15332,114.984250787461,"11",2017-11-01
"Rhode Island","2017-12",2017,12,20000,4455,15545,127.131465957882,"12",2017-12-01
"Rhode Island","2017-02",2017,2,19000,7504,11496,86.7491699366133,"02",2017-02-01
"Rhode Island","2017-03",2017,3,20000,9021,10979,75.6624513283484,"03",2017-03-01
"Rhode Island","2017-04",2017,4,24000,7662,16338,103.202577221906,"04",2017-04-01
"Rhode Island","2017-05",2017,5,23000,7461,15539,102.02554085552,"05",2017-05-01
"Rhode Island","2017-06",2017,6,24000,7165,16835,108.037862987326,"06",2017-06-01
"Rhode Island","2017-07",2017,7,21000,8310,12690,86.5916069600819,"07",2017-07-01
"Rhode Island","2017-08",2017,8,22000,7044,14956,102.988569067622,"08",2017-08-01
"Rhode Island","2017-09",2017,9,23000,7172,15828,104.918467453268,"09",2017-09-01
"Rhode Island","2018-01",2018,1,19000,5413,13587,111.309548191537,"01",2018-01-01
"Rhode Island","2018-10",2018,10,26000,6674,19326,118.295892758768,"10",2018-10-01
"Rhode Island","2018-11",2018,11,25000,6063,18937,121.926407623217,"11",2018-11-01
"Rhode Island","2018-12",2018,12,23000,6139,16861,115.728062047428,"12",2018-12-01
"Rhode Island","2018-02",2018,2,21000,7030,13970,99.6789154477346,"02",2018-02-01
"Rhode Island","2018-03",2018,3,22000,8932,13068,84.4950213371266,"03",2018-03-01
"Rhode Island","2018-04",2018,4,24000,7702,16298,102.82001135575,"04",2018-04-01
"Rhode Island","2018-05",2018,5,25000,8849,16151,95.4297025022896,"05",2018-05-01
"Rhode Island","2018-06",2018,6,25000,6932,18068,113.165476637855,"06",2018-06-01
"Rhode Island","2018-07",2018,7,25000,8326,16674,100.066014523195,"07",2018-07-01
"Rhode Island","2018-08",2018,8,25000,7109,17891,111.439160360024,"08",2018-08-01
"Rhode Island","2018-09",2018,9,27000,6626,20374,121.180039255338,"09",2018-09-01
"Rhode Island","2019-01",2019,1,23000,5540,17460,122.354590049054,"01",2019-01-01
"Rhode Island","2019-10",2019,10,28000,10562,17438,90.4413671490068,"10",2019-10-01
"Rhode Island","2019-11",2019,11,25000,10216,14784,83.9618355293049,"11",2019-11-01
"Rhode Island","2019-12",2019,12,22000,8940,13060,84.4214608920491,"12",2019-12-01
"Rhode Island","2019-02",2019,2,24000,5525,18475,125.148179508891,"02",2019-02-01
"Rhode Island","2019-03",2019,3,25000,7576,17424,106.974459724951,"03",2019-03-01
"Rhode Island","2019-04",2019,4,25000,6999,18001,112.509765930185,"04",2019-04-01
"Rhode Island","2019-05",2019,5,26000,8771,17229,99.0998245664491,"05",2019-05-01
"Rhode Island","2019-06",2019,6,25000,6962,18038,112.87153494775,"06",2019-06-01
"Rhode Island","2019-07",2019,7,26000,7053,18947,114.646174326082,"07",2019-07-01
"Rhode Island","2019-08",2019,8,27000,9224,17776,98.1448763250883,"08",2019-08-01
"Rhode Island","2019-09",2019,9,28000,10104,17896,93.9323955490237,"09",2019-09-01
"South Carolina","2010-01",2010,1,42000,4098,37902,164.440973578029,"01",2010-01-01
"South Carolina","2010-10",2010,10,50000,13361,36639,115.651583781822,"10",2010-10-01
"South Carolina","2010-11",2010,11,47000,11231,35769,122.852089093438,"11",2010-11-01
"South Carolina","2010-12",2010,12,45000,13546,31454,107.450551702934,"12",2010-12-01
"South Carolina","2010-02",2010,2,43000,9276,33724,129.022878567603,"02",2010-02-01
"South Carolina","2010-03",2010,3,43000,10656,32344,120.560608319666,"03",2010-03-01
"South Carolina","2010-04",2010,4,41000,10670,30330,117.398877491775,"04",2010-04-01
"South Carolina","2010-05",2010,5,41000,14593,26407,95.0011692119511,"05",2010-05-01
"South Carolina","2010-06",2010,6,42000,15770,26230,90.8083780508915,"06",2010-06-01
"South Carolina","2010-07",2010,7,43000,15185,27815,95.6088338918965,"07",2010-07-01
"South Carolina","2010-08",2010,8,47000,14766,32234,104.374575008905,"08",2010-08-01
"South Carolina","2010-09",2010,9,48000,13882,34118,110.267929284768,"09",2010-09-01
"South Carolina","2011-01",2011,1,41000,14529,26471,95.3411730807326,"01",2011-01-01
"South Carolina","2011-10",2011,10,52000,15981,36019,105.9678439564,"10",2011-10-01
"South Carolina","2011-11",2011,11,52000,13907,38093,115.596218914531,"11",2011-11-01
"South Carolina","2011-12",2011,12,49000,13437,35563,113.916427759181,"12",2011-12-01
"South Carolina","2011-02",2011,2,42000,13002,28998,105.443438420421,"02",2011-02-01
"South Carolina","2011-03",2011,3,46000,17769,28231,88.5414543116561,"03",2011-03-01
"South Carolina","2011-04",2011,4,49000,15424,33576,104.234446790016,"04",2011-04-01
"South Carolina","2011-05",2011,5,50000,18565,31435,91.6940129803836,"05",2011-05-01
"South Carolina","2011-06",2011,6,49000,16384,32616,99.7675272237856,"06",2011-06-01
"South Carolina","2011-07",2011,7,50000,16368,33632,101.350048216008,"07",2011-07-01
"South Carolina","2011-08",2011,8,51000,15494,35506,106.794598008843,"08",2011-08-01
"South Carolina","2011-09",2011,9,52000,16011,35989,105.832879975298,"09",2011-09-01
"South Carolina","2012-01",2012,1,50000,16320,33680,101.568154402895,"01",2012-01-01
"South Carolina","2012-10",2012,10,53000,14853,38147,112.4401279236,"10",2012-10-01
"South Carolina","2012-11",2012,11,54000,11768,42232,128.427198637635,"11",2012-11-01
"South Carolina","2012-12",2012,12,53000,12442,40558,123.950979493292,"12",2012-12-01
"South Carolina","2012-02",2012,2,51000,16215,34785,103.503682213792,"02",2012-02-01
"South Carolina","2012-03",2012,3,56000,17625,38375,104.244482173175,"03",2012-03-01
"South Carolina","2012-04",2012,4,58000,14861,43139,118.414515309974,"04",2012-04-01
"South Carolina","2012-05",2012,5,60000,18737,41263,104.812222970141,"05",2012-05-01
"South Carolina","2012-06",2012,6,59000,13587,45413,125.127088872663,"06",2012-06-01
"South Carolina","2012-07",2012,7,54000,11966,42034,127.441409210806,"07",2012-07-01
"South Carolina","2012-08",2012,8,53000,11612,41388,128.112424936544,"08",2012-08-01
"South Carolina","2012-09",2012,9,50000,12428,37572,120.369065163068,"09",2012-09-01
"South Carolina","2013-01",2013,1,55000,19723,35277,94.4207272191962,"01",2013-01-01
"South Carolina","2013-10",2013,10,58000,21902,36098,90.3556857150009,"10",2013-10-01
"South Carolina","2013-11",2013,11,57000,20700,36300,93.4362934362934,"11",2013-11-01
"South Carolina","2013-12",2013,12,55000,20414,34586,91.7230222505105,"12",2013-12-01
"South Carolina","2013-02",2013,2,55000,15391,39609,112.539955392025,"02",2013-02-01
"South Carolina","2013-03",2013,3,59000,13813,45187,124.117945971186,"03",2013-03-01
"South Carolina","2013-04",2013,4,61000,10800,50200,139.83286908078,"04",2013-04-01
"South Carolina","2013-05",2013,5,65000,11962,53038,137.829058496401,"05",2013-05-01
"South Carolina","2013-06",2013,6,65000,13338,51662,131.895121141719,"06",2013-06-01
"South Carolina","2013-07",2013,7,62000,21565,40435,96.7749655956441,"07",2013-07-01
"South Carolina","2013-08",2013,8,58000,22647,35353,87.6734410455442,"08",2013-08-01
"South Carolina","2013-09",2013,9,56000,21563,34437,88.797493650323,"09",2013-09-01
"South Carolina","2014-01",2014,1,57000,27085,29915,71.1541892132961,"01",2014-01-01
"South Carolina","2014-10",2014,10,80000,20320,59680,118.979266347687,"10",2014-10-01
"South Carolina","2014-11",2014,11,77000,16057,60943,130.979937027843,"11",2014-11-01
"South Carolina","2014-12",2014,12,73000,15951,57049,128.270620903644,"12",2014-12-01
"South Carolina","2014-02",2014,2,61000,23459,37541,88.8975716027895,"02",2014-02-01
"South Carolina","2014-03",2014,3,69000,30622,38378,77.0472385617635,"03",2014-03-01
"South Carolina","2014-04",2014,4,73000,31674,41326,78.9613466572406,"04",2014-04-01
"South Carolina","2014-05",2014,5,76000,28003,47997,92.299260598252,"05",2014-05-01
"South Carolina","2014-06",2014,6,79000,26573,52427,99.3189546569672,"06",2014-06-01
"South Carolina","2014-07",2014,7,78000,19908,58092,118.666503247947,"07",2014-07-01
"South Carolina","2014-08",2014,8,78000,21401,56599,113.880142050885,"08",2014-08-01
"South Carolina","2014-09",2014,9,77000,21751,55249,111.895575741005,"09",2014-09-01
"South Carolina","2015-01",2015,1,74000,18095,55905,121.40724252131,"01",2015-01-01
"South Carolina","2015-10",2015,10,85000,19888,65112,124.155289451606,"10",2015-10-01
"South Carolina","2015-11",2015,11,84000,15970,68030,136.100830249075,"11",2015-11-01
"South Carolina","2015-12",2015,12,81000,17018,63982,130.551531351384,"12",2015-12-01
"South Carolina","2015-02",2015,2,80000,16141,63859,132.844468020928,"02",2015-02-01
"South Carolina","2015-03",2015,3,81000,16958,64042,130.753996610792,"03",2015-03-01
"South Carolina","2015-04",2015,4,87000,19765,67235,125.949515290591,"04",2015-04-01
"South Carolina","2015-05",2015,5,89000,23500,65500,116.444444444444,"05",2015-05-01
"South Carolina","2015-06",2015,6,92000,22038,69962,122.699451060173,"06",2015-06-01
"South Carolina","2015-07",2015,7,94000,24934,69066,116.141725662973,"07",2015-07-01
"South Carolina","2015-08",2015,8,93000,24626,68374,116.256609933178,"08",2015-08-01
"South Carolina","2015-09",2015,9,93000,19615,73385,130.328997025263,"09",2015-09-01
"South Carolina","2016-01",2016,1,81000,21394,59606,116.424790515069,"01",2016-01-01
"South Carolina","2016-10",2016,10,81000,25650,55350,103.79746835443,"10",2016-10-01
"South Carolina","2016-11",2016,11,81000,22812,58188,112.102647092822,"11",2016-11-01
"South Carolina","2016-12",2016,12,78000,20351,57649,117.231141523726,"12",2016-12-01
"South Carolina","2016-02",2016,2,80000,22154,57846,113.252540282319,"02",2016-02-01
"South Carolina","2016-03",2016,3,86000,23211,62789,114.986585600352,"03",2016-03-01
"South Carolina","2016-04",2016,4,87000,23340,63660,115.388798259924,"04",2016-04-01
"South Carolina","2016-05",2016,5,86000,21077,64923,121.26413702289,"05",2016-05-01
"South Carolina","2016-06",2016,6,85000,22912,62088,115.071539773149,"06",2016-06-01
"South Carolina","2016-07",2016,7,85000,23457,61543,113.488294900283,"07",2016-07-01
"South Carolina","2016-08",2016,8,85000,21897,63103,118.063182315687,"08",2016-08-01
"South Carolina","2016-09",2016,9,85000,27564,57436,102.050389111972,"09",2016-09-01
"South Carolina","2017-01",2017,1,78000,24680,53320,103.856641994546,"01",2017-01-01
"South Carolina","2017-10",2017,10,96000,21115,74885,127.882850189984,"10",2017-10-01
"South Carolina","2017-11",2017,11,95000,20301,74699,129.572163294334,"11",2017-11-01
"South Carolina","2017-12",2017,12,94000,16034,77966,141.712561571878,"12",2017-12-01
"South Carolina","2017-02",2017,2,80000,22735,57265,111.480994792427,"02",2017-02-01
"South Carolina","2017-03",2017,3,85000,30897,54103,93.3639352183404,"03",2017-03-01
"South Carolina","2017-04",2017,4,94000,25337,68663,115.074117834368,"04",2017-04-01
"South Carolina","2017-05",2017,5,97000,25644,71356,116.362806170705,"05",2017-05-01
"South Carolina","2017-06",2017,6,101000,26423,74577,117.054220980514,"06",2017-06-01
"South Carolina","2017-07",2017,7,102000,26241,75759,118.150981355417,"07",2017-07-01
"South Carolina","2017-08",2017,8,104000,23890,80110,125.279537102197,"08",2017-08-01
"South Carolina","2017-09",2017,9,101000,21066,79934,130.968492454901,"09",2017-09-01
"South Carolina","2018-01",2018,1,1e+05,22294,77706,127.080641732219,"01",2018-01-01
"South Carolina","2018-10",2018,10,119000,22932,96068,135.371868218584,"10",2018-10-01
"South Carolina","2018-11",2018,11,119000,20575,98425,141.035285688698,"11",2018-11-01
"South Carolina","2018-12",2018,12,116000,20941,95059,138.832051759517,"12",2018-12-01
"South Carolina","2018-02",2018,2,102000,26498,75502,117.514669489019,"02",2018-02-01
"South Carolina","2018-03",2018,3,104000,29828,74172,110.846758525869,"03",2018-03-01
"South Carolina","2018-04",2018,4,123000,24724,98276,133.053532262869,"04",2018-04-01
"South Carolina","2018-05",2018,5,127000,28266,98734,127.180451612072,"05",2018-05-01
"South Carolina","2018-06",2018,6,132000,20304,111696,146.67507091081,"06",2018-06-01
"South Carolina","2018-07",2018,7,124000,24754,99246,133.436411793969,"07",2018-07-01
"South Carolina","2018-08",2018,8,125000,22671,102329,138.590515402483,"08",2018-08-01
"South Carolina","2018-09",2018,9,123000,20116,102884,143.7770759384,"09",2018-09-01
"South Carolina","2019-01",2019,1,116000,26298,89702,126.076262491391,"01",2019-01-01
"South Carolina","2019-10",2019,10,109000,35094,73906,102.580260107985,"10",2019-10-01
"South Carolina","2019-11",2019,11,103000,36068,66932,96.2579457531567,"11",2019-11-01
"South Carolina","2019-12",2019,12,97000,24852,72148,118.419065751896,"12",2019-12-01
"South Carolina","2019-02",2019,2,114000,23314,90686,132.085584863889,"02",2019-02-01
"South Carolina","2019-03",2019,3,115000,29811,85189,117.655426728632,"03",2019-03-01
"South Carolina","2019-04",2019,4,124000,26981,97019,128.51815791391,"04",2019-04-01
"South Carolina","2019-05",2019,5,123000,29210,93790,123.237632218645,"05",2019-05-01
"South Carolina","2019-06",2019,6,125000,24597,100403,134.231301429841,"06",2019-06-01
"South Carolina","2019-07",2019,7,115000,22379,92621,134.840113845639,"07",2019-07-01
"South Carolina","2019-08",2019,8,114000,32331,81669,111.622280993091,"08",2019-08-01
"South Carolina","2019-09",2019,9,109000,31564,77436,110.178993198828,"09",2019-09-01
"South Dakota","2010-01",2010,1,7000,702,6298,163.541937159179,"01",2010-01-01
"South Dakota","2010-10",2010,10,9000,3010,5990,99.7502081598668,"10",2010-10-01
"South Dakota","2010-11",2010,11,8000,2597,5403,101.972256298953,"11",2010-11-01
"South Dakota","2010-12",2010,12,8000,2956,5044,92.0774005111355,"12",2010-12-01
"South Dakota","2010-02",2010,2,8000,1490,6510,137.197049525817,"02",2010-02-01
"South Dakota","2010-03",2010,3,8000,1535,6465,135.605663345569,"03",2010-03-01
"South Dakota","2010-04",2010,4,9000,2067,6933,125.291406885335,"04",2010-04-01
"South Dakota","2010-05",2010,5,9000,2856,6144,103.643724696356,"05",2010-05-01
"South Dakota","2010-06",2010,6,10000,3598,6402,94.1609060155905,"06",2010-06-01
"South Dakota","2010-07",2010,7,10000,3379,6621,98.9760071754242,"07",2010-07-01
"South Dakota","2010-08",2010,8,10000,3256,6744,101.750150875075,"08",2010-08-01
"South Dakota","2010-09",2010,9,9000,2891,6109,102.749978975696,"09",2010-09-01
"South Dakota","2011-01",2011,1,8000,2557,5443,103.116415648385,"01",2011-01-01
"South Dakota","2011-10",2011,10,12000,3830,8170,103.221730890714,"10",2011-10-01
"South Dakota","2011-11",2011,11,11000,2875,8125,117.117117117117,"11",2011-11-01
"South Dakota","2011-12",2011,12,11000,3602,7398,101.328585125325,"12",2011-12-01
"South Dakota","2011-02",2011,2,8000,2118,5882,116.268037161494,"02",2011-02-01
"South Dakota","2011-03",2011,3,9000,3779,5221,81.7121840519603,"03",2011-03-01
"South Dakota","2011-04",2011,4,10000,2758,7242,113.528766264305,"04",2011-04-01
"South Dakota","2011-05",2011,5,11000,4119,6881,91.0245386599643,"05",2011-05-01
"South Dakota","2011-06",2011,6,12000,3413,8587,111.425420099916,"06",2011-06-01
"South Dakota","2011-07",2011,7,12000,3448,8552,110.719834282755,"07",2011-07-01
"South Dakota","2011-08",2011,8,12000,3953,8047,100.883846298502,"08",2011-08-01
"South Dakota","2011-09",2011,9,12000,3361,8639,112.479656272378,"09",2011-09-01
"South Dakota","2012-01",2012,1,10000,3817,6183,89.4984439458638,"01",2012-01-01
"South Dakota","2012-10",2012,10,13000,6314,6686,69.2347519933727,"10",2012-10-01
"South Dakota","2012-11",2012,11,12000,5424,6576,75.4820936639118,"11",2012-11-01
"South Dakota","2012-12",2012,12,11000,5590,5410,65.2200120554551,"12",2012-12-01
"South Dakota","2012-02",2012,2,10000,4176,5824,82.1670428893905,"02",2012-02-01
"South Dakota","2012-03",2012,3,11000,3654,7346,100.259314862836,"03",2012-03-01
"South Dakota","2012-04",2012,4,12000,3386,8614,111.971922526973,"04",2012-04-01
"South Dakota","2012-05",2012,5,14000,3574,10426,118.652554910663,"05",2012-05-01
"South Dakota","2012-06",2012,6,14000,9237,4763,40.9949649266256,"06",2012-06-01
"South Dakota","2012-07",2012,7,14000,4708,9292,99.3371819542442,"07",2012-07-01
"South Dakota","2012-08",2012,8,14000,5040,8960,94.1176470588235,"08",2012-08-01
"South Dakota","2012-09",2012,9,13000,6098,6902,72.2798198764269,"09",2012-09-01
"South Dakota","2013-01",2013,1,12000,7259,4741,49.2341243055195,"01",2013-01-01
"South Dakota","2013-10",2013,10,15000,5557,9443,91.8713820109938,"10",2013-10-01
"South Dakota","2013-11",2013,11,14000,3775,10225,115.049226441632,"11",2013-11-01
"South Dakota","2013-12",2013,12,13000,3711,9289,111.172281730597,"12",2013-12-01
"South Dakota","2013-02",2013,2,12000,5054,6946,81.458895273836,"02",2013-02-01
"South Dakota","2013-03",2013,3,13000,7407,5593,54.8145244278924,"03",2013-03-01
"South Dakota","2013-04",2013,4,11000,5851,5149,61.1121001720966,"04",2013-04-01
"South Dakota","2013-05",2013,5,13000,5179,7821,86.0443368722152,"05",2013-05-01
"South Dakota","2013-06",2013,6,14000,3046,10954,128.522820603074,"06",2013-06-01
"South Dakota","2013-07",2013,7,14000,9073,4927,42.7079270142591,"07",2013-07-01
"South Dakota","2013-08",2013,8,14000,4342,9658,105.310216988333,"08",2013-08-01
"South Dakota","2013-09",2013,9,14000,4987,9013,94.9386422288935,"09",2013-09-01
"South Dakota","2014-01",2014,1,11000,7603,3397,36.5209912379724,"01",2014-01-01
"South Dakota","2014-10",2014,10,15000,5611,9389,91.1066906021057,"10",2014-10-01
"South Dakota","2014-11",2014,11,13000,4581,8419,95.7738467663955,"11",2014-11-01
"South Dakota","2014-12",2014,12,13000,4210,8790,102.149912841371,"12",2014-12-01
"South Dakota","2014-02",2014,2,11000,8764,2236,22.6269985832827,"02",2014-02-01
"South Dakota","2014-03",2014,3,12000,7207,4793,49.9088873848076,"03",2014-03-01
"South Dakota","2014-04",2014,4,12000,8741,3259,31.4256786075888,"04",2014-04-01
"South Dakota","2014-05",2014,5,14000,8125,5875,53.1073446327684,"05",2014-05-01
"South Dakota","2014-06",2014,6,15000,6543,8457,78.5127419579446,"06",2014-06-01
"South Dakota","2014-07",2014,7,16000,4197,11803,116.878744367975,"07",2014-07-01
"South Dakota","2014-08",2014,8,17000,5438,11562,103.05731348605,"08",2014-08-01
"South Dakota","2014-09",2014,9,16000,5815,10185,93.3761173504469,"09",2014-09-01
"South Dakota","2015-01",2015,1,13000,4765,8235,92.7103855896426,"01",2015-01-01
"South Dakota","2015-10",2015,10,19000,11252,7748,51.223059632421,"10",2015-10-01
"South Dakota","2015-11",2015,11,17000,10677,6323,45.6913682841348,"11",2015-11-01
"South Dakota","2015-12",2015,12,16000,8510,7490,61.1179110567115,"12",2015-12-01
"South Dakota","2015-02",2015,2,14000,4197,9803,107.743034566137,"02",2015-02-01
"South Dakota","2015-03",2015,3,16000,4776,11224,108.047747400847,"03",2015-03-01
"South Dakota","2015-04",2015,4,17000,13333,3667,24.1782876734909,"04",2015-04-01
"South Dakota","2015-05",2015,5,17000,11070,5930,42.2515140719629,"05",2015-05-01
"South Dakota","2015-06",2015,6,18000,10976,7024,48.4815019326339,"06",2015-06-01
"South Dakota","2015-07",2015,7,19000,20485,-1485,-7.5218437381284,"07",2015-07-01
"South Dakota","2015-08",2015,8,19000,11690,7310,47.6376669925057,"08",2015-08-01
"South Dakota","2015-09",2015,9,19000,10189,8811,60.3720579670424,"09",2015-09-01
"South Dakota","2016-01",2016,1,15000,11931,3069,22.7915784783335,"01",2016-01-01
"South Dakota","2016-10",2016,10,18000,9307,8693,63.6686563884718,"10",2016-10-01
"South Dakota","2016-11",2016,11,16000,7825,8175,68.6253934942287,"11",2016-11-01
"South Dakota","2016-12",2016,12,16000,6576,9424,83.4868887313962,"12",2016-12-01
"South Dakota","2016-02",2016,2,16000,10582,5418,40.7644270559025,"02",2016-02-01
"South Dakota","2016-03",2016,3,17000,12507,4493,30.4537906259532,"03",2016-03-01
"South Dakota","2016-04",2016,4,18000,9821,8179,58.7973113834873,"04",2016-04-01
"South Dakota","2016-05",2016,5,19000,8343,10657,77.9504809274769,"05",2016-05-01
"South Dakota","2016-06",2016,6,20000,20738,-738,-3.62315283028131,"06",2016-06-01
"South Dakota","2016-07",2016,7,20000,9769,10231,68.7359333534885,"07",2016-07-01
"South Dakota","2016-08",2016,8,20000,9037,10963,75.5105554981575,"08",2016-08-01
"South Dakota","2016-09",2016,9,19000,11509,7491,49.1068209380838,"09",2016-09-01
"South Dakota","2017-01",2017,1,15000,7495,7505,66.7259390975772,"01",2017-01-01
"South Dakota","2017-10",2017,10,22000,5892,16108,115.502653090492,"10",2017-10-01
"South Dakota","2017-11",2017,11,20000,5916,14084,108.689612594536,"11",2017-11-01
"South Dakota","2017-12",2017,12,19000,4730,14270,120.269700800674,"12",2017-12-01
"South Dakota","2017-02",2017,2,15000,7757,7243,63.6551390780859,"02",2017-02-01
"South Dakota","2017-03",2017,3,17000,10342,6658,48.7016311901104,"03",2017-03-01
"South Dakota","2017-04",2017,4,19000,6628,12372,96.5506477290464,"04",2017-04-01
"South Dakota","2017-05",2017,5,21000,6394,14606,106.636489742279,"05",2017-05-01
"South Dakota","2017-06",2017,6,22000,6503,15497,108.739430937094,"06",2017-06-01
"South Dakota","2017-07",2017,7,21000,8036,12964,89.2960462873674,"07",2017-07-01
"South Dakota","2017-08",2017,8,22000,5651,16349,118.25250443022,"08",2017-08-01
"South Dakota","2017-09",2017,9,21000,5576,15424,116.074653822998,"09",2017-09-01
"South Dakota","2018-01",2018,1,19000,5146,13854,114.751925784809,"01",2018-01-01
"South Dakota","2018-10",2018,10,24000,4184,19816,140.618790803293,"10",2018-10-01
"South Dakota","2018-11",2018,11,22000,4080,17920,137.423312883436,"11",2018-11-01
"South Dakota","2018-12",2018,12,22000,3776,18224,141.402855369336,"12",2018-12-01
"South Dakota","2018-02",2018,2,19000,6919,12081,93.2211890890852,"02",2018-02-01
"South Dakota","2018-03",2018,3,22000,7548,14452,97.8204954650061,"03",2018-03-01
"South Dakota","2018-04",2018,4,24000,14625,9375,48.5436893203884,"04",2018-04-01
"South Dakota","2018-05",2018,5,28000,10441,17559,91.3555838817929,"05",2018-05-01
"South Dakota","2018-06",2018,6,28000,6208,21792,127.408793264733,"06",2018-06-01
"South Dakota","2018-07",2018,7,27000,5099,21901,136.45907972211,"07",2018-07-01
"South Dakota","2018-08",2018,8,25000,4453,20547,139.523987369708,"08",2018-08-01
"South Dakota","2018-09",2018,9,23000,4303,18697,136.959308500897,"09",2018-09-01
"South Dakota","2019-01",2019,1,21000,3382,17618,144.516446558937,"01",2019-01-01
"South Dakota","2019-10",2019,10,23000,4708,18292,132.034069582792,"10",2019-10-01
"South Dakota","2019-11",2019,11,21000,10725,10275,64.7754137115839,"11",2019-11-01
"South Dakota","2019-12",2019,12,20000,4977,15023,120.29467109741,"12",2019-12-01
"South Dakota","2019-02",2019,2,21000,3485,17515,143.067183990198,"02",2019-02-01
"South Dakota","2019-03",2019,3,21000,5256,15744,119.926873857404,"03",2019-03-01
"South Dakota","2019-04",2019,4,22000,3857,18143,140.33337200758,"04",2019-04-01
"South Dakota","2019-05",2019,5,24000,4482,19518,137.054982093954,"05",2019-05-01
"South Dakota","2019-06",2019,6,26000,3239,22761,155.689319060159,"06",2019-06-01
"South Dakota","2019-07",2019,7,26000,3560,22440,151.826792963464,"07",2019-07-01
"South Dakota","2019-08",2019,8,24000,4796,19204,133.379636060564,"08",2019-08-01
"South Dakota","2019-09",2019,9,23000,4692,18308,132.225913621262,"09",2019-09-01
"Tennessee","2010-01",2010,1,46000,6286,39714,151.91064529702,"01",2010-01-01
"Tennessee","2010-10",2010,10,64000,18314,45686,111.004203416187,"10",2010-10-01
"Tennessee","2010-11",2010,11,60000,17856,42144,108.26140567201,"11",2010-11-01
"Tennessee","2010-12",2010,12,55000,20806,34194,90.2144948948632,"12",2010-12-01
"Tennessee","2010-02",2010,2,48000,9793,38207,132.220165071895,"02",2010-02-01
"Tennessee","2010-03",2010,3,49000,14214,34786,110.057898566773,"03",2010-03-01
"Tennessee","2010-04",2010,4,51000,14446,36554,111.707361794457,"04",2010-04-01
"Tennessee","2010-05",2010,5,53000,18749,34251,95.4745013867789,"05",2010-05-01
"Tennessee","2010-06",2010,6,57000,13825,43175,121.92022590893,"06",2010-06-01
"Tennessee","2010-07",2010,7,59000,20570,38430,96.59419379163,"07",2010-07-01
"Tennessee","2010-08",2010,8,60000,19557,40443,101.670500395943,"08",2010-08-01
"Tennessee","2010-09",2010,9,62000,18714,43286,107.257724806106,"09",2010-09-01
"Tennessee","2011-01",2011,1,52000,15109,36891,109.943524713526,"01",2011-01-01
"Tennessee","2011-10",2011,10,73000,16532,56468,126.140374391279,"10",2011-10-01
"Tennessee","2011-11",2011,11,74000,15472,58528,130.829756795422,"11",2011-11-01
"Tennessee","2011-12",2011,12,74000,20889,53111,111.943428637671,"12",2011-12-01
"Tennessee","2011-02",2011,2,61000,16592,44408,114.465408805031,"02",2011-02-01
"Tennessee","2011-03",2011,3,68000,20771,47229,106.406371450136,"03",2011-03-01
"Tennessee","2011-04",2011,4,76000,15707,60293,131.490507812926,"04",2011-04-01
"Tennessee","2011-05",2011,5,77000,23670,53330,105.95013410152,"05",2011-05-01
"Tennessee","2011-06",2011,6,76000,18539,57461,121.560414220586,"06",2011-06-01
"Tennessee","2011-07",2011,7,73000,20293,52707,112.992400287267,"07",2011-07-01
"Tennessee","2011-08",2011,8,70000,21194,48806,107.037743711209,"08",2011-08-01
"Tennessee","2011-09",2011,9,75000,17990,57010,122.615334982256,"09",2011-09-01
"Tennessee","2012-01",2012,1,84000,21374,62626,118.864235959535,"01",2012-01-01
"Tennessee","2012-10",2012,10,87000,16641,70359,135.77445219556,"10",2012-10-01
"Tennessee","2012-11",2012,11,84000,14635,69365,140.64987073554,"11",2012-11-01
"Tennessee","2012-12",2012,12,77000,15887,61113,131.585690139632,"12",2012-12-01
"Tennessee","2012-02",2012,2,89000,22979,66021,117.916752248189,"02",2012-02-01
"Tennessee","2012-03",2012,3,99000,21581,77419,128.409948499349,"03",2012-03-01
"Tennessee","2012-04",2012,4,94000,19462,74538,131.388482487529,"04",2012-04-01
"Tennessee","2012-05",2012,5,93000,20244,72756,128.494224859595,"05",2012-05-01
"Tennessee","2012-06",2012,6,87000,17077,69923,134.367823822747,"06",2012-06-01
"Tennessee","2012-07",2012,7,85000,15308,69692,138.956015472345,"07",2012-07-01
"Tennessee","2012-08",2012,8,85000,14370,70630,142.155580154976,"08",2012-08-01
"Tennessee","2012-09",2012,9,86000,14954,71046,140.749252134636,"09",2012-09-01
"Tennessee","2013-01",2013,1,78000,23897,54103,106.191546365447,"01",2013-01-01
"Tennessee","2013-10",2013,10,91000,33884,57116,91.4704846097178,"10",2013-10-01
"Tennessee","2013-11",2013,11,86000,24333,61667,111.783419285255,"11",2013-11-01
"Tennessee","2013-12",2013,12,79000,26370,52630,99.8956059599507,"12",2013-12-01
"Tennessee","2013-02",2013,2,81000,23007,57993,111.517494014826,"02",2013-02-01
"Tennessee","2013-03",2013,3,87000,24214,62786,112.910245113025,"03",2013-03-01
"Tennessee","2013-04",2013,4,84000,17930,66070,129.637986853723,"04",2013-04-01
"Tennessee","2013-05",2013,5,88000,18666,69334,130.002062512891,"05",2013-05-01
"Tennessee","2013-06",2013,6,88000,19792,68208,126.554846370788,"06",2013-06-01
"Tennessee","2013-07",2013,7,87000,32355,54645,91.5671735578736,"07",2013-07-01
"Tennessee","2013-08",2013,8,85000,31576,53424,91.6552292066978,"08",2013-08-01
"Tennessee","2013-09",2013,9,87000,33351,53649,89.1542238951068,"09",2013-09-01
"Tennessee","2014-01",2014,1,75000,29453,45547,87.2105157343494,"01",2014-01-01
"Tennessee","2014-10",2014,10,98000,24698,73302,119.483610164795,"10",2014-10-01
"Tennessee","2014-11",2014,11,96000,22110,73890,125.1206502413,"11",2014-11-01
"Tennessee","2014-12",2014,12,94000,20961,73039,127.06744026235,"12",2014-12-01
"Tennessee","2014-02",2014,2,82000,29887,52113,93.152913207075,"02",2014-02-01
"Tennessee","2014-03",2014,3,89000,27331,61669,106.023329980831,"03",2014-03-01
"Tennessee","2014-04",2014,4,91000,31052,59948,98.233539802707,"04",2014-04-01
"Tennessee","2014-05",2014,5,93000,29256,63744,104.27954456223,"05",2014-05-01
"Tennessee","2014-06",2014,6,93000,24316,68684,117.0922977258,"06",2014-06-01
"Tennessee","2014-07",2014,7,94000,19003,74997,132.734529171792,"07",2014-07-01
"Tennessee","2014-08",2014,8,97000,23835,73165,121.099019323871,"08",2014-08-01
"Tennessee","2014-09",2014,9,96000,25740,70260,115.42631838344,"09",2014-09-01
"Tennessee","2015-01",2015,1,97000,23683,73317,121.503442904137,"01",2015-01-01
"Tennessee","2015-10",2015,10,123000,38407,84593,104.819493578345,"10",2015-10-01
"Tennessee","2015-11",2015,11,117000,28275,88725,122.147651006711,"11",2015-11-01
"Tennessee","2015-12",2015,12,110000,28788,81212,117.030290803239,"12",2015-12-01
"Tennessee","2015-02",2015,2,96000,17451,78549,138.472115715155,"02",2015-02-01
"Tennessee","2015-03",2015,3,101000,23141,77859,125.436398933471,"03",2015-03-01
"Tennessee","2015-04",2015,4,104000,28365,75635,114.282476485476,"04",2015-04-01
"Tennessee","2015-05",2015,5,109000,33721,75279,105.491133049796,"05",2015-05-01
"Tennessee","2015-06",2015,6,116000,32902,83098,111.614350378101,"06",2015-06-01
"Tennessee","2015-07",2015,7,128000,40255,87745,104.300020801759,"07",2015-07-01
"Tennessee","2015-08",2015,8,133000,40994,92006,105.757669804706,"08",2015-08-01
"Tennessee","2015-09",2015,9,132000,33398,98602,119.229978597081,"09",2015-09-01
"Tennessee","2016-01",2016,1,108000,39324,68676,93.2312454182618,"01",2016-01-01
"Tennessee","2016-10",2016,10,107000,49184,57816,74.0357527019413,"10",2016-10-01
"Tennessee","2016-11",2016,11,1e+05,32920,67080,100.932891965092,"11",2016-11-01
"Tennessee","2016-12",2016,12,105000,27584,77416,116.780305315875,"12",2016-12-01
"Tennessee","2016-02",2016,2,108000,30878,77122,111.064387447976,"02",2016-02-01
"Tennessee","2016-03",2016,3,120000,34366,85634,110.949302307503,"03",2016-03-01
"Tennessee","2016-04",2016,4,118000,33864,84136,110.804403940368,"04",2016-04-01
"Tennessee","2016-05",2016,5,126000,32249,93751,118.485424868404,"05",2016-05-01
"Tennessee","2016-06",2016,6,123000,40640,82360,100.659985333659,"06",2016-06-01
"Tennessee","2016-07",2016,7,129000,44403,84597,97.5727063545613,"07",2016-07-01
"Tennessee","2016-08",2016,8,123000,43811,79189,94.9445779954559,"08",2016-08-01
"Tennessee","2016-09",2016,9,117000,49186,67814,81.6121694968289,"09",2016-09-01
"Tennessee","2017-01",2017,1,107000,33975,73025,103.599929065437,"01",2017-01-01
"Tennessee","2017-10",2017,10,129000,30995,98005,122.510078439951,"10",2017-10-01
"Tennessee","2017-11",2017,11,129000,28449,100551,127.725168149687,"11",2017-11-01
"Tennessee","2017-12",2017,12,127000,23232,103768,138.143671121998,"12",2017-12-01
"Tennessee","2017-02",2017,2,116000,33086,82914,111.229760004293,"02",2017-02-01
"Tennessee","2017-03",2017,3,114000,40478,73522,95.1876642628724,"03",2017-03-01
"Tennessee","2017-04",2017,4,121000,34351,86649,111.552548744456,"04",2017-04-01
"Tennessee","2017-05",2017,5,120000,35653,84347,108.378251623804,"05",2017-05-01
"Tennessee","2017-06",2017,6,129000,36524,92476,111.737270728112,"06",2017-06-01
"Tennessee","2017-07",2017,7,133000,38357,94643,110.462951615633,"07",2017-07-01
"Tennessee","2017-08",2017,8,139000,34631,104369,120.219315675196,"08",2017-08-01
"Tennessee","2017-09",2017,9,135000,31905,103095,123.53734160151,"09",2017-09-01
"Tennessee","2018-01",2018,1,130000,31788,98212,121.408262664722,"01",2018-01-01
"Tennessee","2018-10",2018,10,166000,56287,109713,98.7129251823093,"10",2018-10-01
"Tennessee","2018-11",2018,11,162000,55217,106783,98.3191923284089,"11",2018-11-01
"Tennessee","2018-12",2018,12,159000,48896,110104,105.922191865163,"12",2018-12-01
"Tennessee","2018-02",2018,2,125000,32340,92660,117.783144782001,"02",2018-02-01
"Tennessee","2018-03",2018,3,129000,39335,89665,106.531618498827,"03",2018-03-01
"Tennessee","2018-04",2018,4,141000,40757,100243,110.304417436467,"04",2018-04-01
"Tennessee","2018-05",2018,5,144000,62702,81298,78.6620352004335,"05",2018-05-01
"Tennessee","2018-06",2018,6,151000,42315,108685,112.443421358922,"06",2018-06-01
"Tennessee","2018-07",2018,7,152000,55460,96540,93.0685433336547,"07",2018-07-01
"Tennessee","2018-08",2018,8,162000,54345,107655,99.5215974485197,"08",2018-08-01
"Tennessee","2018-09",2018,9,164000,45740,118260,112.768189186612,"09",2018-09-01
"Tennessee","2019-01",2019,1,153000,47365,105635,105.442567314651,"01",2019-01-01
"Tennessee","2019-10",2019,10,165000,67532,97468,83.8319027058641,"10",2019-10-01
"Tennessee","2019-11",2019,11,152000,69592,82408,74.3781363948157,"11",2019-11-01
"Tennessee","2019-12",2019,12,134000,49647,84353,91.8642831083546,"12",2019-12-01
"Tennessee","2019-02",2019,2,150000,47388,102612,103.969846191258,"02",2019-02-01
"Tennessee","2019-03",2019,3,146000,53491,92509,92.7450361169176,"03",2019-03-01
"Tennessee","2019-04",2019,4,141000,51381,89619,93.1682442652861,"04",2019-04-01
"Tennessee","2019-05",2019,5,141000,63811,77189,75.3758343057746,"05",2019-05-01
"Tennessee","2019-06",2019,6,142000,49172,92828,97.114640219279,"06",2019-06-01
"Tennessee","2019-07",2019,7,142000,46355,95645,101.558227814499,"07",2019-07-01
"Tennessee","2019-08",2019,8,152000,66685,85315,78.0254704254979,"08",2019-08-01
"Tennessee","2019-09",2019,9,158000,62796,95204,86.2370695121288,"09",2019-09-01
"Texas","2010-01",2010,1,188000,14884,173116,170.655152698093,"01",2010-01-01
"Texas","2010-10",2010,10,231000,83298,147702,93.9885077219709,"10",2010-10-01
"Texas","2010-11",2010,11,236000,71990,164010,106.503457904477,"11",2010-11-01
"Texas","2010-12",2010,12,237000,90760,146240,89.2360263607518,"12",2010-12-01
"Texas","2010-02",2010,2,196000,48481,147519,120.679316593109,"02",2010-02-01
"Texas","2010-03",2010,3,201000,55263,145737,113.74018098594,"03",2010-03-01
"Texas","2010-04",2010,4,208000,62557,145443,107.513758653445,"04",2010-04-01
"Texas","2010-05",2010,5,204000,77870,126130,89.4951573420371,"05",2010-05-01
"Texas","2010-06",2010,6,197000,60760,136240,105.710738671633,"06",2010-06-01
"Texas","2010-07",2010,7,190000,79643,110357,81.8541553090568,"07",2010-07-01
"Texas","2010-08",2010,8,199000,80601,118399,84.6913995300446,"08",2010-08-01
"Texas","2010-09",2010,9,211000,74721,136279,95.3930582631308,"09",2010-09-01
"Texas","2011-01",2011,1,236000,82000,154000,96.8553459119497,"01",2011-01-01
"Texas","2011-10",2011,10,305000,95662,209338,104.496059022318,"10",2011-10-01
"Texas","2011-11",2011,11,324000,67958,256042,130.647671434184,"11",2011-11-01
"Texas","2011-12",2011,12,324000,69917,254083,129.003317957844,"12",2011-12-01
"Texas","2011-02",2011,2,244000,76751,167249,104.28587907754,"02",2011-02-01
"Texas","2011-03",2011,3,255000,100292,154708,87.0878038345924,"03",2011-03-01
"Texas","2011-04",2011,4,252000,72264,179736,110.857819554437,"04",2011-04-01
"Texas","2011-05",2011,5,249000,104913,144087,81.425095998169,"05",2011-05-01
"Texas","2011-06",2011,6,258000,80365,177635,104.996084110354,"06",2011-06-01
"Texas","2011-07",2011,7,270000,105250,164750,87.8081279147235,"07",2011-07-01
"Texas","2011-08",2011,8,273000,97817,175183,94.4848806823851,"08",2011-08-01
"Texas","2011-09",2011,9,286000,92551,193449,102.204986910614,"09",2011-09-01
"Texas","2012-01",2012,1,341000,95468,245532,112.508591695153,"01",2012-01-01
"Texas","2012-10",2012,10,357000,76198,280802,129.641411086847,"10",2012-10-01
"Texas","2012-11",2012,11,353000,75088,277912,129.838724748183,"11",2012-11-01
"Texas","2012-12",2012,12,339000,84369,254631,120.287975737477,"12",2012-12-01
"Texas","2012-02",2012,2,343000,83192,259808,121.920636708338,"02",2012-02-01
"Texas","2012-03",2012,3,362000,101354,260646,112.504046582095,"03",2012-03-01
"Texas","2012-04",2012,4,364000,84789,279211,124.428629043938,"04",2012-04-01
"Texas","2012-05",2012,5,379000,90062,288938,123.198212603025,"05",2012-05-01
"Texas","2012-06",2012,6,370000,87585,282415,123.437175606718,"06",2012-06-01
"Texas","2012-07",2012,7,351000,79037,271963,126.483535137674,"07",2012-07-01
"Texas","2012-08",2012,8,343000,76475,266525,127.075511055486,"08",2012-08-01
"Texas","2012-09",2012,9,344000,71827,272173,130.906843470963,"09",2012-09-01
"Texas","2013-01",2013,1,330000,119673,210327,93.5466438945634,"01",2013-01-01
"Texas","2013-10",2013,10,359000,124861,234139,96.7794469899413,"10",2013-10-01
"Texas","2013-11",2013,11,346000,119035,226965,97.6120076983453,"11",2013-11-01
"Texas","2013-12",2013,12,350000,106453,243547,106.71284885848,"12",2013-12-01
"Texas","2013-02",2013,2,353000,95662,257338,114.71352599507,"02",2013-02-01
"Texas","2013-03",2013,3,372000,89498,282502,122.428266211338,"03",2013-03-01
"Texas","2013-04",2013,4,382000,83592,298408,128.184333064142,"04",2013-04-01
"Texas","2013-05",2013,5,379000,100116,278884,116.416066255354,"05",2013-05-01
"Texas","2013-06",2013,6,371000,104845,266155,111.866258970883,"06",2013-06-01
"Texas","2013-07",2013,7,366000,140124,225876,89.2571780828414,"07",2013-07-01
"Texas","2013-08",2013,8,358000,113610,244390,103.640720086512,"08",2013-08-01
"Texas","2013-09",2013,9,359000,116024,242976,102.300515342383,"09",2013-09-01
"Texas","2014-01",2014,1,350000,137986,212014,86.8934764521933,"01",2014-01-01
"Texas","2014-10",2014,10,480000,123481,356519,118.154175524996,"10",2014-10-01
"Texas","2014-11",2014,11,453000,118404,334596,117.113635886343,"11",2014-11-01
"Texas","2014-12",2014,12,441000,108402,332598,121.07637030808,"12",2014-12-01
"Texas","2014-02",2014,2,374000,124775,249225,99.9348403588793,"02",2014-02-01
"Texas","2014-03",2014,3,385000,125687,259313,101.554572565975,"03",2014-03-01
"Texas","2014-04",2014,4,407000,121917,285083,107.798766158017,"04",2014-04-01
"Texas","2014-05",2014,5,412000,123773,288227,107.592954478856,"05",2014-05-01
"Texas","2014-06",2014,6,428000,106595,321405,120.242426509788,"06",2014-06-01
"Texas","2014-07",2014,7,441000,98788,342212,126.79496394881,"07",2014-07-01
"Texas","2014-08",2014,8,474000,120609,353391,118.86500204336,"08",2014-08-01
"Texas","2014-09",2014,9,476000,108763,367237,125.60199602232,"09",2014-09-01
"Texas","2015-01",2015,1,440000,119571,320429,114.526664176664,"01",2015-01-01
"Texas","2015-10",2015,10,554000,165300,388700,108.077297372445,"10",2015-10-01
"Texas","2015-11",2015,11,540000,140251,399749,117.529852951337,"11",2015-11-01
"Texas","2015-12",2015,12,533000,118809,414191,127.089684247993,"12",2015-12-01
"Texas","2015-02",2015,2,442000,95834,346166,128.725963773209,"02",2015-02-01
"Texas","2015-03",2015,3,444000,127944,316056,110.519911040242,"03",2015-03-01
"Texas","2015-04",2015,4,460000,138629,321371,107.369004842732,"04",2015-04-01
"Texas","2015-05",2015,5,466000,139363,326637,107.91442489878,"05",2015-05-01
"Texas","2015-06",2015,6,481000,162299,318701,99.0833189543276,"06",2015-06-01
"Texas","2015-07",2015,7,501000,168672,332328,99.2509765974985,"07",2015-07-01
"Texas","2015-08",2015,8,534000,164537,369463,105.781941400384,"08",2015-08-01
"Texas","2015-09",2015,9,545000,156565,388435,110.733859300279,"09",2015-09-01
"Texas","2016-01",2016,1,507000,152567,354433,107.474449146182,"01",2016-01-01
"Texas","2016-10",2016,10,505000,153661,351339,106.682800408708,"10",2016-10-01
"Texas","2016-11",2016,11,498000,124387,373613,120.058098899881,"11",2016-11-01
"Texas","2016-12",2016,12,485000,112278,372722,124.806873851038,"12",2016-12-01
"Texas","2016-02",2016,2,524000,131104,392896,119.949198905823,"02",2016-02-01
"Texas","2016-03",2016,3,569000,142355,426645,119.952766199717,"03",2016-03-01
"Texas","2016-04",2016,4,585000,129796,455204,127.366129636987,"04",2016-04-01
"Texas","2016-05",2016,5,572000,130719,441281,125.592448759746,"05",2016-05-01
"Texas","2016-06",2016,6,533000,148131,384869,113.008804473736,"06",2016-06-01
"Texas","2016-07",2016,7,532000,165023,366977,105.298390440488,"07",2016-07-01
"Texas","2016-08",2016,8,526000,143328,382672,114.345134224177,"08",2016-08-01
"Texas","2016-09",2016,9,532000,161911,370089,106.667569760387,"09",2016-09-01
"Texas","2017-01",2017,1,466000,127806,338194,113.907235696507,"01",2017-01-01
"Texas","2017-10",2017,10,505000,121598,383402,122.37574968321,"10",2017-10-01
"Texas","2017-11",2017,11,480000,119479,360521,120.27810815725,"11",2017-11-01
"Texas","2017-12",2017,12,432000,100959,331041,124.227567223745,"12",2017-12-01
"Texas","2017-02",2017,2,453000,125486,327514,113.231435160056,"02",2017-02-01
"Texas","2017-03",2017,3,454000,144217,309783,103.568771867065,"03",2017-03-01
"Texas","2017-04",2017,4,484000,140263,343737,110.125700225706,"04",2017-04-01
"Texas","2017-05",2017,5,479000,134696,344304,112.206695171551,"05",2017-05-01
"Texas","2017-06",2017,6,476000,143501,332499,107.344136651918,"06",2017-06-01
"Texas","2017-07",2017,7,471000,141026,329974,107.830059507276,"07",2017-07-01
"Texas","2017-08",2017,8,490000,135820,354180,113.189095906171,"08",2017-08-01
"Texas","2017-09",2017,9,508000,117280,390720,124.974411463664,"09",2017-09-01
"Texas","2018-01",2018,1,423000,120701,302299,111.200457604455,"01",2018-01-01
"Texas","2018-10",2018,10,629000,258363,370637,83.5367262326692,"10",2018-10-01
"Texas","2018-11",2018,11,656000,237034,418966,93.8297981935738,"11",2018-11-01
"Texas","2018-12",2018,12,671000,211522,459478,104.128395666057,"12",2018-12-01
"Texas","2018-02",2018,2,442000,110504,331496,119.997683274691,"02",2018-02-01
"Texas","2018-03",2018,3,479000,150477,328523,104.379667565296,"03",2018-03-01
"Texas","2018-04",2018,4,495000,185816,309184,90.8274776150972,"04",2018-04-01
"Texas","2018-05",2018,5,511000,295989,215011,53.2872195283951,"05",2018-05-01
"Texas","2018-06",2018,6,554000,184207,369793,100.186803972328,"06",2018-06-01
"Texas","2018-07",2018,7,617000,257473,359527,82.2271242222458,"07",2018-07-01
"Texas","2018-08",2018,8,642000,236793,405207,92.218986723836,"08",2018-08-01
"Texas","2018-09",2018,9,641000,211709,429291,100.688746102129,"09",2018-09-01
"Texas","2019-01",2019,1,657000,210007,446993,103.111739582264,"01",2019-01-01
"Texas","2019-10",2019,10,571000,271060,299940,71.2395791273781,"10",2019-10-01
"Texas","2019-11",2019,11,536000,256600,279400,70.5021448397679,"11",2019-11-01
"Texas","2019-12",2019,12,496000,230448,265552,73.1097064070656,"12",2019-12-01
"Texas","2019-02",2019,2,630000,214472,415528,98.4113149991948,"02",2019-02-01
"Texas","2019-03",2019,3,613000,245507,367493,85.612114985667,"03",2019-03-01
"Texas","2019-04",2019,4,634000,206036,427964,101.891823683747,"04",2019-04-01
"Texas","2019-05",2019,5,636000,258707,377293,84.3388953031551,"05",2019-05-01
"Texas","2019-06",2019,6,625000,205589,419411,100.991224299864,"06",2019-06-01
"Texas","2019-07",2019,7,595000,199654,395346,99.501418227304,"07",2019-07-01
"Texas","2019-08",2019,8,598000,291667,306333,68.8646426134722,"08",2019-08-01
"Texas","2019-09",2019,9,591000,279743,311257,71.4922772850313,"09",2019-09-01
"Utah","2010-01",2010,1,22000,1981,20019,166.957174429757,"01",2010-01-01
"Utah","2010-10",2010,10,29000,7490,21510,117.895313784599,"10",2010-10-01
"Utah","2010-11",2010,11,31000,6644,24356,129.401763893316,"11",2010-11-01
"Utah","2010-12",2010,12,31000,8255,22745,115.883326964718,"12",2010-12-01
"Utah","2010-02",2010,2,24000,4605,19395,135.605663345569,"02",2010-02-01
"Utah","2010-03",2010,3,27000,6169,20831,125.605233802647,"03",2010-03-01
"Utah","2010-04",2010,4,31000,6419,24581,131.382452764638,"04",2010-04-01
"Utah","2010-05",2010,5,32000,8738,23262,114.20295547155,"05",2010-05-01
"Utah","2010-06",2010,6,31000,6230,24770,133.064732742412,"06",2010-06-01
"Utah","2010-07",2010,7,28000,7914,20086,111.85610068497,"07",2010-07-01
"Utah","2010-08",2010,8,26000,8018,17982,105.720500911282,"08",2010-08-01
"Utah","2010-09",2010,9,27000,7778,19222,110.541146701938,"09",2010-09-01
"Utah","2011-01",2011,1,28000,7028,20972,119.744204636291,"01",2011-01-01
"Utah","2011-10",2011,10,39000,11712,27288,107.619498343587,"10",2011-10-01
"Utah","2011-11",2011,11,35000,8510,26490,121.765111468628,"11",2011-11-01
"Utah","2011-12",2011,12,32000,9495,22505,108.470900108447,"12",2011-12-01
"Utah","2011-02",2011,2,27000,9461,17539,96.2069060091605,"02",2011-02-01
"Utah","2011-03",2011,3,29000,10120,18880,96.5235173824131,"03",2011-03-01
"Utah","2011-04",2011,4,33000,8823,24177,115.61580948282,"04",2011-04-01
"Utah","2011-05",2011,5,34000,17119,16881,66.0458929165281,"05",2011-05-01
"Utah","2011-06",2011,6,34000,8371,25629,120.974251256756,"06",2011-06-01
"Utah","2011-07",2011,7,35000,9992,25008,111.166429587482,"07",2011-07-01
"Utah","2011-08",2011,8,37000,9942,27058,115.282689276128,"08",2011-08-01
"Utah","2011-09",2011,9,38000,8640,29360,125.90051457976,"09",2011-09-01
"Utah","2012-01",2012,1,28000,9629,18371,97.6427755188817,"01",2012-01-01
"Utah","2012-10",2012,10,35000,11033,23967,104.129646123433,"10",2012-10-01
"Utah","2012-11",2012,11,36000,10249,25751,111.35808341802,"11",2012-11-01
"Utah","2012-12",2012,12,33000,9566,23434,110.106657895973,"12",2012-12-01
"Utah","2012-02",2012,2,28000,9852,18148,95.8892528796365,"02",2012-02-01
"Utah","2012-03",2012,3,29000,10465,18535,93.9313315596098,"03",2012-03-01
"Utah","2012-04",2012,4,33000,9073,23927,113.740403584246,"04",2012-04-01
"Utah","2012-05",2012,5,37000,8947,28053,122.110257470564,"05",2012-05-01
"Utah","2012-06",2012,6,36000,9786,26214,114.506617743415,"06",2012-06-01
"Utah","2012-07",2012,7,34000,9055,24945,115.875043548949,"07",2012-07-01
"Utah","2012-08",2012,8,32000,10683,21317,99.8852001967997,"08",2012-08-01
"Utah","2012-09",2012,9,33000,8103,24897,121.144442011532,"09",2012-09-01
"Utah","2013-01",2013,1,32000,16651,15349,63.0983946887012,"01",2013-01-01
"Utah","2013-10",2013,10,39000,14730,24270,90.3405918481295,"10",2013-10-01
"Utah","2013-11",2013,11,39000,13952,25048,94.6064360175253,"11",2013-11-01
"Utah","2013-12",2013,12,40000,11533,28467,110.480662876215,"12",2013-12-01
"Utah","2013-02",2013,2,33000,10989,22011,100.075018754689,"02",2013-02-01
"Utah","2013-03",2013,3,36000,12609,23391,96.2414367709683,"03",2013-03-01
"Utah","2013-04",2013,4,39000,8945,30055,125.372823026384,"04",2013-04-01
"Utah","2013-05",2013,5,41000,8722,32278,129.83387635252,"05",2013-05-01
"Utah","2013-06",2013,6,40000,10788,29212,115.035047649051,"06",2013-06-01
"Utah","2013-07",2013,7,38000,19107,18893,66.1670198049276,"07",2013-07-01
"Utah","2013-08",2013,8,36000,16585,19415,73.842350480175,"08",2013-08-01
"Utah","2013-09",2013,9,35000,14151,20849,84.8365241805864,"09",2013-09-01
"Utah","2014-01",2014,1,37000,15608,21392,81.3260340632603,"01",2014-01-01
"Utah","2014-10",2014,10,54000,12417,41583,125.217941189756,"10",2014-10-01
"Utah","2014-11",2014,11,50000,10672,39328,129.64135021097,"11",2014-11-01
"Utah","2014-12",2014,12,50000,9129,40871,138.243501496727,"12",2014-12-01
"Utah","2014-02",2014,2,38000,14140,23860,91.5228231683928,"02",2014-02-01
"Utah","2014-03",2014,3,41000,14319,26681,96.4623366293679,"03",2014-03-01
"Utah","2014-04",2014,4,45000,15345,29655,98.2848620432513,"04",2014-04-01
"Utah","2014-05",2014,5,48000,12860,35140,115.478146565889,"05",2014-05-01
"Utah","2014-06",2014,6,50000,10475,39525,130.715171558495,"06",2014-06-01
"Utah","2014-07",2014,7,48000,9894,38106,131.64058451653,"07",2014-07-01
"Utah","2014-08",2014,8,50000,11742,38258,123.928606135208,"08",2014-08-01
"Utah","2014-09",2014,9,51000,10916,40084,129.478648491505,"09",2014-09-01
"Utah","2015-01",2015,1,47000,10716,36284,125.732899022801,"01",2015-01-01
"Utah","2015-10",2015,10,60000,19672,40328,101.235063761422,"10",2015-10-01
"Utah","2015-11",2015,11,58000,24631,33369,80.7662983626,"11",2015-11-01
"Utah","2015-12",2015,12,56000,15678,40322,112.508719551327,"12",2015-12-01
"Utah","2015-02",2015,2,50000,8524,41476,141.740140796938,"02",2015-02-01
"Utah","2015-03",2015,3,53000,15183,37817,110.927943915639,"03",2015-03-01
"Utah","2015-04",2015,4,60000,15952,44048,115.989045713082,"04",2015-04-01
"Utah","2015-05",2015,5,63000,18078,44922,110.811810848812,"05",2015-05-01
"Utah","2015-06",2015,6,61000,21187,39813,96.8839354155767,"06",2015-06-01
"Utah","2015-07",2015,7,60000,19915,40085,100.319089032097,"07",2015-07-01
"Utah","2015-08",2015,8,58000,21645,36355,91.2926109611401,"08",2015-08-01
"Utah","2015-09",2015,9,60000,22624,37376,90.4725019364834,"09",2015-09-01
"Utah","2016-01",2016,1,53000,20156,32844,89.791678057849,"01",2016-01-01
"Utah","2016-10",2016,10,61000,22032,38968,93.8626071875903,"10",2016-10-01
"Utah","2016-11",2016,11,61000,18297,42703,107.703948446978,"11",2016-11-01
"Utah","2016-12",2016,12,58000,15406,42594,116.050459090538,"12",2016-12-01
"Utah","2016-02",2016,2,54000,19507,34493,93.8495653475179,"02",2016-02-01
"Utah","2016-03",2016,3,57000,26676,30324,72.4795640326976,"03",2016-03-01
"Utah","2016-04",2016,4,65000,20029,44971,105.778028672571,"04",2016-04-01
"Utah","2016-05",2016,5,69000,15302,53698,127.394367867903,"05",2016-05-01
"Utah","2016-06",2016,6,68000,21793,46207,102.918935774504,"06",2016-06-01
"Utah","2016-07",2016,7,63000,22405,40595,95.0646917627774,"07",2016-07-01
"Utah","2016-08",2016,8,60000,20890,39110,96.6992211645444,"08",2016-08-01
"Utah","2016-09",2016,9,61000,23318,37682,89.3806779098176,"09",2016-09-01
"Utah","2017-01",2017,1,58000,18417,39583,103.597367078006,"01",2017-01-01
"Utah","2017-10",2017,10,73000,16268,56732,127.104897611686,"10",2017-10-01
"Utah","2017-11",2017,11,71000,15313,55687,129.035023692839,"11",2017-11-01
"Utah","2017-12",2017,12,66000,11342,54658,141.341056605725,"12",2017-12-01
"Utah","2017-02",2017,2,57000,17980,39020,104.081088290211,"02",2017-02-01
"Utah","2017-03",2017,3,59000,23471,35529,86.1611960567957,"03",2017-03-01
"Utah","2017-04",2017,4,63000,19299,43701,106.200561367696,"04",2017-04-01
"Utah","2017-05",2017,5,66000,18749,47251,111.508100390565,"05",2017-05-01
"Utah","2017-06",2017,6,68000,20281,47719,108.107067205854,"06",2017-06-01
"Utah","2017-07",2017,7,68000,18184,49816,115.603824375754,"07",2017-07-01
"Utah","2017-08",2017,8,69000,19288,49712,112.61326567597,"08",2017-08-01
"Utah","2017-09",2017,9,72000,16446,55554,125.622413676141,"09",2017-09-01
"Utah","2018-01",2018,1,68000,16751,51249,120.940165897748,"01",2018-01-01
"Utah","2018-10",2018,10,87000,21867,65133,119.656094133208,"10",2018-10-01
"Utah","2018-11",2018,11,86000,18730,67270,128.463668480856,"11",2018-11-01
"Utah","2018-12",2018,12,83000,20321,62679,121.328674712788,"12",2018-12-01
"Utah","2018-02",2018,2,72000,17141,54859,123.083653986381,"02",2018-02-01
"Utah","2018-03",2018,3,75000,21818,53182,109.859736825797,"03",2018-03-01
"Utah","2018-04",2018,4,76000,20290,55710,115.712950462146,"04",2018-04-01
"Utah","2018-05",2018,5,75000,24184,50816,102.468140022584,"05",2018-05-01
"Utah","2018-06",2018,6,75000,17571,57429,124.075574423956,"06",2018-06-01
"Utah","2018-07",2018,7,73000,21489,51511,109.03068081999,"07",2018-07-01
"Utah","2018-08",2018,8,76000,19080,56920,119.730753050063,"08",2018-08-01
"Utah","2018-09",2018,9,81000,17594,63406,128.620402864272,"09",2018-09-01
"Utah","2019-01",2019,1,85000,19260,65740,126.107807404566,"01",2019-01-01
"Utah","2019-10",2019,10,77000,29998,47002,87.8558477728556,"10",2019-10-01
"Utah","2019-11",2019,11,75000,28697,46303,89.3044157497324,"11",2019-11-01
"Utah","2019-12",2019,12,69000,24832,44168,94.1427231648052,"12",2019-12-01
"Utah","2019-02",2019,2,87000,17719,69281,132.317917474384,"02",2019-02-01
"Utah","2019-03",2019,3,92000,24201,67799,116.692627430057,"03",2019-03-01
"Utah","2019-04",2019,4,93000,22398,70602,122.362605937711,"04",2019-04-01
"Utah","2019-05",2019,5,93000,24006,68994,117.932413722373,"05",2019-05-01
"Utah","2019-06",2019,6,90000,18853,71147,130.721247921509,"06",2019-06-01
"Utah","2019-07",2019,7,84000,16407,67593,134.638023245391,"07",2019-07-01
"Utah","2019-08",2019,8,81000,24557,56443,106.94316814612,"08",2019-08-01
"Utah","2019-09",2019,9,80000,28840,51160,94.0095553105476,"09",2019-09-01
"Vermont","2010-01",2010,1,7000,1118,5882,144.912540034491,"01",2010-01-01
"Vermont","2010-10",2010,10,9000,3410,5590,90.088638195004,"10",2010-10-01
"Vermont","2010-11",2010,11,9000,3191,5809,95.2998113362316,"11",2010-11-01
"Vermont","2010-12",2010,12,9000,2653,6347,108.933321891358,"12",2010-12-01
"Vermont","2010-02",2010,2,8000,2105,5895,116.674913409203,"02",2010-02-01
"Vermont","2010-03",2010,3,7000,1952,5048,112.77926720286,"03",2010-03-01
"Vermont","2010-04",2010,4,9000,2711,6289,107.403296046452,"04",2010-04-01
"Vermont","2010-05",2010,5,9000,3366,5634,91.1208151382824,"05",2010-05-01
"Vermont","2010-06",2010,6,9000,2507,6493,112.853045972017,"06",2010-06-01
"Vermont","2010-07",2010,7,9000,2741,6259,106.617834937399,"07",2010-07-01
"Vermont","2010-08",2010,8,9000,3176,5824,95.6636005256242,"08",2010-08-01
"Vermont","2010-09",2010,9,9000,3510,5490,87.7697841726619,"09",2010-09-01
"Vermont","2011-01",2011,1,8000,2721,5279,98.4796194384852,"01",2011-01-01
"Vermont","2011-10",2011,10,9000,3606,5394,85.5782960495002,"10",2011-10-01
"Vermont","2011-11",2011,11,9000,2056,6944,125.61505065123,"11",2011-11-01
"Vermont","2011-12",2011,12,9000,5447,3553,49.1866823561985,"12",2011-12-01
"Vermont","2011-02",2011,2,9000,2538,6462,112.01248049922,"02",2011-02-01
"Vermont","2011-03",2011,3,8000,3387,4613,81.0222183191358,"03",2011-03-01
"Vermont","2011-04",2011,4,9000,2917,6083,102.089452043299,"04",2011-04-01
"Vermont","2011-05",2011,5,9000,3206,5794,94.9369162706865,"05",2011-05-01
"Vermont","2011-06",2011,6,9000,3384,5616,90.6976744186046,"06",2011-06-01
"Vermont","2011-07",2011,7,9000,3885,5115,79.3946449359721,"07",2011-07-01
"Vermont","2011-08",2011,8,9000,2755,6245,106.252658443216,"08",2011-08-01
"Vermont","2011-09",2011,9,9000,3412,5588,90.0418949403803,"09",2011-09-01
"Vermont","2012-01",2012,1,8000,3411,4589,80.4311629129787,"01",2012-01-01
"Vermont","2012-10",2012,10,10000,1591,8409,145.095332585627,"10",2012-10-01
"Vermont","2012-11",2012,11,9000,1786,7214,133.765992953829,"11",2012-11-01
"Vermont","2012-12",2012,12,10000,2773,7227,113.160573083849,"12",2012-12-01
"Vermont","2012-02",2012,2,9000,4660,4340,63.5431918008785,"02",2012-02-01
"Vermont","2012-03",2012,3,9000,3986,5014,77.2216232866164,"03",2012-03-01
"Vermont","2012-04",2012,4,10000,2573,7427,118.142050425515,"04",2012-04-01
"Vermont","2012-05",2012,5,11000,2902,8098,116.501222845634,"05",2012-05-01
"Vermont","2012-06",2012,6,11000,3281,7719,108.101673552272,"06",2012-06-01
"Vermont","2012-07",2012,7,10000,2204,7796,127.761389708292,"07",2012-07-01
"Vermont","2012-08",2012,8,10000,1956,8044,134.560053529609,"08",2012-08-01
"Vermont","2012-09",2012,9,10000,1428,8572,150.017500875044,"09",2012-09-01
"Vermont","2013-01",2013,1,9000,3442,5558,89.3425494293522,"01",2013-01-01
"Vermont","2013-10",2013,10,10000,3147,6853,104.251920590249,"10",2013-10-01
"Vermont","2013-11",2013,11,9000,2722,6278,107.114826821362,"11",2013-11-01
"Vermont","2013-12",2013,12,10000,3073,6927,105.974145184732,"12",2013-12-01
"Vermont","2013-02",2013,2,9000,2935,6065,101.633850020947,"02",2013-02-01
"Vermont","2013-03",2013,3,9000,2571,6429,111.122634171636,"03",2013-03-01
"Vermont","2013-04",2013,4,9000,2247,6753,120.085356094959,"04",2013-04-01
"Vermont","2013-05",2013,5,10000,2192,7808,128.083989501312,"05",2013-05-01
"Vermont","2013-06",2013,6,10000,2172,7828,128.623069339468,"06",2013-06-01
"Vermont","2013-07",2013,7,10000,3250,6750,101.88679245283,"07",2013-07-01
"Vermont","2013-08",2013,8,11000,3159,7841,110.756409350943,"08",2013-08-01
"Vermont","2013-09",2013,9,10000,2652,7348,116.155548529877,"09",2013-09-01
"Vermont","2014-01",2014,1,10000,3808,6192,89.6871378910776,"01",2014-01-01
"Vermont","2014-10",2014,10,12000,4607,7393,89.0347443848979,"10",2014-10-01
"Vermont","2014-11",2014,11,11000,2847,8153,117.758359211382,"11",2014-11-01
"Vermont","2014-12",2014,12,12000,2325,9675,135.078534031414,"12",2014-12-01
"Vermont","2014-02",2014,2,10000,3342,6658,99.805126667666,"02",2014-02-01
"Vermont","2014-03",2014,3,9000,4281,4719,71.0639259091936,"03",2014-03-01
"Vermont","2014-04",2014,4,10000,4931,5069,67.8990020762173,"04",2014-04-01
"Vermont","2014-05",2014,5,11000,4039,6961,92.5726444577432,"05",2014-05-01
"Vermont","2014-06",2014,6,13000,3997,9003,105.93634170736,"06",2014-06-01
"Vermont","2014-07",2014,7,12000,3394,8606,111.809796024425,"07",2014-07-01
"Vermont","2014-08",2014,8,12000,4029,7971,99.4572337638031,"08",2014-08-01
"Vermont","2014-09",2014,9,11000,3920,7080,94.9061662198391,"09",2014-09-01
"Vermont","2015-01",2015,1,12000,2880,9120,122.58064516129,"01",2015-01-01
"Vermont","2015-10",2015,10,13000,3852,9148,108.568715879421,"10",2015-10-01
"Vermont","2015-11",2015,11,13000,2957,10043,125.87579118882,"11",2015-11-01
"Vermont","2015-12",2015,12,15000,2725,12275,138.504936530324,"12",2015-12-01
"Vermont","2015-02",2015,2,13000,2594,10406,133.461587790176,"02",2015-02-01
"Vermont","2015-03",2015,3,12000,3163,8837,116.560047484007,"03",2015-03-01
"Vermont","2015-04",2015,4,12000,3447,8553,110.739949504758,"04",2015-04-01
"Vermont","2015-05",2015,5,13000,3446,9554,116.186306700717,"05",2015-05-01
"Vermont","2015-06",2015,6,13000,3549,9451,114.218381775334,"06",2015-06-01
"Vermont","2015-07",2015,7,15000,3770,11230,119.659030367608,"07",2015-07-01
"Vermont","2015-08",2015,8,14000,3771,10229,115.120139553205,"08",2015-08-01
"Vermont","2015-09",2015,9,14000,2975,11025,129.896907216495,"09",2015-09-01
"Vermont","2016-01",2016,1,15000,3585,11415,122.841000807102,"01",2016-01-01
"Vermont","2016-10",2016,10,13000,5614,7386,79.3596217900505,"10",2016-10-01
"Vermont","2016-11",2016,11,13000,4341,8659,99.8673663571882,"11",2016-11-01
"Vermont","2016-12",2016,12,14000,4614,9386,100.848823466208,"12",2016-12-01
"Vermont","2016-02",2016,2,15000,3535,11465,123.711896412193,"02",2016-02-01
"Vermont","2016-03",2016,3,13000,4799,8201,92.1512444519355,"03",2016-03-01
"Vermont","2016-04",2016,4,13000,5199,7801,85.72998516402,"04",2016-04-01
"Vermont","2016-05",2016,5,13000,4328,8672,100.092336103416,"05",2016-05-01
"Vermont","2016-06",2016,6,14000,4552,9448,101.854247520483,"06",2016-06-01
"Vermont","2016-07",2016,7,15000,4443,10557,108.594352723345,"07",2016-07-01
"Vermont","2016-08",2016,8,15000,4291,10709,111.025866984604,"08",2016-08-01
"Vermont","2016-09",2016,9,15000,5787,9213,88.6419396738346,"09",2016-09-01
"Vermont","2017-01",2017,1,13000,4666,8334,94.3507302162346,"01",2017-01-01
"Vermont","2017-10",2017,10,14000,3469,10531,120.567863071727,"10",2017-10-01
"Vermont","2017-11",2017,11,14000,4673,9327,99.89824880844,"11",2017-11-01
"Vermont","2017-12",2017,12,16000,2804,13196,140.353116358222,"12",2017-12-01
"Vermont","2017-02",2017,2,14000,5467,8533,87.6663070837828,"02",2017-02-01
"Vermont","2017-03",2017,3,13000,5870,7130,75.5696873343932,"03",2017-03-01
"Vermont","2017-04",2017,4,15000,6170,8830,83.4199338686821,"04",2017-04-01
"Vermont","2017-05",2017,5,15000,5768,9232,88.9060092449923,"05",2017-05-01
"Vermont","2017-06",2017,6,16000,4840,11160,107.101727447217,"06",2017-06-01
"Vermont","2017-07",2017,7,17000,5046,11954,108.445976594394,"07",2017-07-01
"Vermont","2017-08",2017,8,18000,4400,13600,121.428571428571,"08",2017-08-01
"Vermont","2017-09",2017,9,17000,4002,12998,123.778687744024,"09",2017-09-01
"Vermont","2018-01",2018,1,15000,3912,11088,117.258883248731,"01",2018-01-01
"Vermont","2018-10",2018,10,17000,3740,13260,127.868852459016,"10",2018-10-01
"Vermont","2018-11",2018,11,17000,3143,13857,137.586258253488,"11",2018-11-01
"Vermont","2018-12",2018,12,18000,3322,14678,137.679392177094,"12",2018-12-01
"Vermont","2018-02",2018,2,16000,4827,11173,107.293417198828,"02",2018-02-01
"Vermont","2018-03",2018,3,14000,5848,8152,82.1442966545748,"03",2018-03-01
"Vermont","2018-04",2018,4,15000,4830,10170,102.571860816944,"04",2018-04-01
"Vermont","2018-05",2018,5,15000,5322,9678,95.2465308532625,"05",2018-05-01
"Vermont","2018-06",2018,6,17000,4048,12952,123.07107563664,"06",2018-06-01
"Vermont","2018-07",2018,7,20000,4561,15439,125.719636822605,"07",2018-07-01
"Vermont","2018-08",2018,8,21000,4524,16476,129.102021626704,"08",2018-08-01
"Vermont","2018-09",2018,9,20000,4495,15505,126.597264747908,"09",2018-09-01
"Vermont","2019-01",2019,1,17000,3097,13903,138.358959048614,"01",2019-01-01
"Vermont","2019-10",2019,10,18000,6760,11240,90.7915993537964,"10",2019-10-01
"Vermont","2019-11",2019,11,16000,4939,11061,105.649744495917,"11",2019-11-01
"Vermont","2019-12",2019,12,17000,3320,13680,134.645669291339,"12",2019-12-01
"Vermont","2019-02",2019,2,17000,3372,13628,133.791478499902,"02",2019-02-01
"Vermont","2019-03",2019,3,15000,5261,9739,96.1354326045111,"03",2019-03-01
"Vermont","2019-04",2019,4,15000,4762,10238,103.61299463617,"04",2019-04-01
"Vermont","2019-05",2019,5,16000,4476,11524,112.561047079508,"05",2019-05-01
"Vermont","2019-06",2019,6,17000,3960,13040,124.427480916031,"06",2019-06-01
"Vermont","2019-07",2019,7,21000,3881,17119,137.607009364575,"07",2019-07-01
"Vermont","2019-08",2019,8,22000,4620,17380,130.578512396694,"08",2019-08-01
"Vermont","2019-09",2019,9,20000,4805,15195,122.515621850433,"09",2019-09-01
"Virginia","2010-01",2010,1,71000,7739,63261,160.685302073941,"01",2010-01-01
"Virginia","2010-10",2010,10,95000,37476,57524,86.8444095534285,"10",2010-10-01
"Virginia","2010-11",2010,11,87000,30695,56305,95.6795105994307,"11",2010-11-01
"Virginia","2010-12",2010,12,88000,33274,54726,90.2518264426011,"12",2010-12-01
"Virginia","2010-02",2010,2,68000,25105,42895,92.1432790934966,"02",2010-02-01
"Virginia","2010-03",2010,3,77000,24945,52055,102.123694148806,"03",2010-03-01
"Virginia","2010-04",2010,4,83000,29348,53652,95.5103784669064,"04",2010-04-01
"Virginia","2010-05",2010,5,97000,30067,66933,105.350720486043,"05",2010-05-01
"Virginia","2010-06",2010,6,97000,30588,66412,104.103834216384,"06",2010-06-01
"Virginia","2010-07",2010,7,101000,34710,66290,97.6936113772014,"07",2010-07-01
"Virginia","2010-08",2010,8,101000,37157,63843,92.4209413927633,"08",2010-08-01
"Virginia","2010-09",2010,9,99000,30905,68095,104.838150956468,"09",2010-09-01
"Virginia","2011-01",2011,1,88000,28667,59333,101.713423675932,"01",2011-01-01
"Virginia","2011-10",2011,10,119000,35868,83132,107.358524679082,"10",2011-10-01
"Virginia","2011-11",2011,11,122000,29415,92585,122.293035696595,"11",2011-11-01
"Virginia","2011-12",2011,12,129000,35660,93340,113.373011053079,"12",2011-12-01
"Virginia","2011-02",2011,2,95000,28261,66739,108.288915390918,"02",2011-02-01
"Virginia","2011-03",2011,3,91000,37207,53793,83.9158548285195,"03",2011-03-01
"Virginia","2011-04",2011,4,91000,28229,62771,105.294852762331,"04",2011-04-01
"Virginia","2011-05",2011,5,87000,43653,43347,66.3543891070239,"05",2011-05-01
"Virginia","2011-06",2011,6,89000,38456,50544,79.3120763243786,"06",2011-06-01
"Virginia","2011-07",2011,7,88000,38585,49415,78.0740214085397,"07",2011-07-01
"Virginia","2011-08",2011,8,93000,35526,57474,89.4356005788712,"08",2011-08-01
"Virginia","2011-09",2011,9,111000,39471,71529,95.073469306378,"09",2011-09-01
"Virginia","2012-01",2012,1,146000,35824,110176,121.189721928898,"01",2012-01-01
"Virginia","2012-10",2012,10,127000,35764,91236,112.108328623037,"10",2012-10-01
"Virginia","2012-11",2012,11,123000,31639,91361,118.160360581742,"11",2012-11-01
"Virginia","2012-12",2012,12,123000,35405,87595,110.5962564313,"12",2012-12-01
"Virginia","2012-02",2012,2,150000,40083,109917,115.651583781822,"02",2012-02-01
"Virginia","2012-03",2012,3,136000,41519,94481,106.446070561461,"03",2012-03-01
"Virginia","2012-04",2012,4,125000,34184,90816,114.101919790934,"04",2012-04-01
"Virginia","2012-05",2012,5,130000,35563,94437,114.079836678485,"05",2012-05-01
"Virginia","2012-06",2012,6,134000,35898,98102,115.483407691674,"06",2012-06-01
"Virginia","2012-07",2012,7,134000,33153,100847,120.664301568024,"07",2012-07-01
"Virginia","2012-08",2012,8,134000,30483,103517,125.869542749099,"08",2012-08-01
"Virginia","2012-09",2012,9,125000,31187,93813,120.129076043461,"09",2012-09-01
"Virginia","2013-01",2013,1,121000,52123,68877,79.5700166933336,"01",2013-01-01
"Virginia","2013-10",2013,10,135000,52058,82942,88.6805162035305,"10",2013-10-01
"Virginia","2013-11",2013,11,125000,41326,83674,100.614455947958,"11",2013-11-01
"Virginia","2013-12",2013,12,108000,34079,73921,104.056194089204,"12",2013-12-01
"Virginia","2013-02",2013,2,122000,42287,79713,97.0411535909719,"02",2013-02-01
"Virginia","2013-03",2013,3,131000,37210,93790,111.515367695143,"03",2013-03-01
"Virginia","2013-04",2013,4,133000,32929,100071,120.61905995938,"04",2013-04-01
"Virginia","2013-05",2013,5,136000,35523,100477,117.158631786991,"05",2013-05-01
"Virginia","2013-06",2013,6,134000,35895,98105,115.488978486712,"06",2013-06-01
"Virginia","2013-07",2013,7,132000,59457,72543,75.7799401432175,"07",2013-07-01
"Virginia","2013-08",2013,8,132000,49954,82046,90.1832331248557,"08",2013-08-01
"Virginia","2013-09",2013,9,136000,48627,87373,94.6481283885889,"09",2013-09-01
"Virginia","2014-01",2014,1,1e+05,47278,52722,71.5952144923207,"01",2014-01-01
"Virginia","2014-10",2014,10,161000,40793,120207,119.138919585912,"10",2014-10-01
"Virginia","2014-11",2014,11,156000,37353,118647,122.725791686708,"11",2014-11-01
"Virginia","2014-12",2014,12,164000,37318,126682,125.852631160651,"12",2014-12-01
"Virginia","2014-02",2014,2,111000,43581,67419,87.2280551943641,"02",2014-02-01
"Virginia","2014-03",2014,3,122000,47438,74562,88.0109538592287,"03",2014-03-01
"Virginia","2014-04",2014,4,139000,47304,91696,98.4369632428719,"04",2014-04-01
"Virginia","2014-05",2014,5,154000,46391,107609,107.399034886796,"05",2014-05-01
"Virginia","2014-06",2014,6,166000,38333,127667,124.959747079522,"06",2014-06-01
"Virginia","2014-07",2014,7,164000,37039,126961,126.30484632335,"07",2014-07-01
"Virginia","2014-08",2014,8,157000,37911,119089,122.19833667674,"08",2014-08-01
"Virginia","2014-09",2014,9,148000,40384,107616,114.251741124512,"09",2014-09-01
"Virginia","2015-01",2015,1,157000,40388,116612,118.155105680183,"01",2015-01-01
"Virginia","2015-10",2015,10,182000,60093,121907,100.710883833899,"10",2015-10-01
"Virginia","2015-11",2015,11,180000,47648,132352,116.277762159123,"11",2015-11-01
"Virginia","2015-12",2015,12,183000,42748,140252,124.25536438861,"12",2015-12-01
"Virginia","2015-02",2015,2,156000,34602,121398,127.383763024522,"02",2015-02-01
"Virginia","2015-03",2015,3,148000,41829,106171,111.859621027346,"03",2015-03-01
"Virginia","2015-04",2015,4,154000,48144,105856,104.733259458604,"04",2015-04-01
"Virginia","2015-05",2015,5,169000,54553,114447,102.389142619424,"05",2015-05-01
"Virginia","2015-06",2015,6,175000,59397,115603,98.6386344535126,"06",2015-06-01
"Virginia","2015-07",2015,7,178000,69288,108712,87.923392966905,"07",2015-07-01
"Virginia","2015-08",2015,8,175000,67595,107405,88.5467548795317,"08",2015-08-01
"Virginia","2015-09",2015,9,181000,62267,118733,97.6153773425906,"09",2015-09-01
"Virginia","2016-01",2016,1,181000,59143,121857,101.487030644241,"01",2016-01-01
"Virginia","2016-10",2016,10,180000,76034,103966,81.21265144473,"10",2016-10-01
"Virginia","2016-11",2016,11,180000,63274,116726,95.9625771763526,"11",2016-11-01
"Virginia","2016-12",2016,12,175000,49252,125748,112.148832563366,"12",2016-12-01
"Virginia","2016-02",2016,2,175000,52528,122472,107.65444253015,"02",2016-02-01
"Virginia","2016-03",2016,3,166000,60789,105211,92.7831596770566,"03",2016-03-01
"Virginia","2016-04",2016,4,169000,62281,106719,92.2851423160571,"04",2016-04-01
"Virginia","2016-05",2016,5,168000,57964,110036,97.3925050007966,"05",2016-05-01
"Virginia","2016-06",2016,6,169000,68067,100933,85.1514550738821,"06",2016-06-01
"Virginia","2016-07",2016,7,162000,76183,85817,72.0597187876549,"07",2016-07-01
"Virginia","2016-08",2016,8,169000,71027,97973,81.6349827311094,"08",2016-08-01
"Virginia","2016-09",2016,9,178000,84024,93976,71.7308338167496,"09",2016-09-01
"Virginia","2017-01",2017,1,168000,58214,109786,97.0638422025162,"01",2017-01-01
"Virginia","2017-10",2017,10,184000,54267,129733,108.897161587631,"10",2017-10-01
"Virginia","2017-11",2017,11,181000,49161,131839,114.562415005149,"11",2017-11-01
"Virginia","2017-12",2017,12,173000,40220,132780,124.547415814652,"12",2017-12-01
"Virginia","2017-02",2017,2,165000,57860,107140,96.1500493583416,"02",2017-02-01
"Virginia","2017-03",2017,3,165000,70675,94325,80.046674445741,"03",2017-03-01
"Virginia","2017-04",2017,4,189000,58465,130535,105.497747156163,"04",2017-04-01
"Virginia","2017-05",2017,5,205000,60124,144876,109.289238243237,"05",2017-05-01
"Virginia","2017-06",2017,6,233000,62105,170895,115.81979295505,"06",2017-06-01
"Virginia","2017-07",2017,7,224000,63371,160629,111.792073660877,"07",2017-07-01
"Virginia","2017-08",2017,8,211000,63126,147874,107.887613725075,"08",2017-08-01
"Virginia","2017-09",2017,9,190000,56079,133921,108.843907850731,"09",2017-09-01
"Virginia","2018-01",2018,1,174000,53548,120452,105.869530824266,"01",2018-01-01
"Virginia","2018-10",2018,10,207000,78171,128829,90.3521045267576,"10",2018-10-01
"Virginia","2018-11",2018,11,210000,73724,136276,96.0623704727129,"11",2018-11-01
"Virginia","2018-12",2018,12,195000,71082,123918,93.1427154035222,"12",2018-12-01
"Virginia","2018-02",2018,2,176000,54729,121271,105.119859228792,"02",2018-02-01
"Virginia","2018-03",2018,3,183000,71987,111013,87.0734586469114,"03",2018-03-01
"Virginia","2018-04",2018,4,194000,62999,131001,101.946700181713,"04",2018-04-01
"Virginia","2018-05",2018,5,201000,92442,108558,73.9894084691353,"05",2018-05-01
"Virginia","2018-06",2018,6,208000,62621,145379,107.441033770476,"06",2018-06-01
"Virginia","2018-07",2018,7,206000,84266,121734,83.8775468018989,"07",2018-07-01
"Virginia","2018-08",2018,8,207000,75139,131861,93.472366457668,"08",2018-08-01
"Virginia","2018-09",2018,9,212000,71860,140140,98.7388149087578,"09",2018-09-01
"Virginia","2019-01",2019,1,199000,70745,128255,95.093514244935,"01",2019-01-01
"Virginia","2019-10",2019,10,223000,100271,122729,75.9294833127624,"10",2019-10-01
"Virginia","2019-11",2019,11,218000,87196,130804,85.7180303804768,"11",2019-11-01
"Virginia","2019-12",2019,12,209000,90341,118659,79.2801520673747,"12",2019-12-01
"Virginia","2019-02",2019,2,198000,71319,126681,94.0750559745135,"02",2019-02-01
"Virginia","2019-03",2019,3,208000,93602,114398,75.8602396535832,"03",2019-03-01
"Virginia","2019-04",2019,4,216000,78993,137007,92.888305824206,"04",2019-04-01
"Virginia","2019-05",2019,5,226000,93597,132403,82.8562220546501,"05",2019-05-01
"Virginia","2019-06",2019,6,225000,77666,147334,97.3574831662625,"06",2019-06-01
"Virginia","2019-07",2019,7,219000,66479,152521,106.852693192844,"07",2019-07-01
"Virginia","2019-08",2019,8,213000,85823,127177,85.1186153676257,"08",2019-08-01
"Virginia","2019-09",2019,9,211000,99327,111673,71.971178788826,"09",2019-09-01
"Washington","2010-01",2010,1,44000,6312,37688,149.817141039911,"01",2010-01-01
"Washington","2010-10",2010,10,60000,24511,35489,83.9866999562187,"10",2010-10-01
"Washington","2010-11",2010,11,62000,20532,41468,100.489507100276,"11",2010-11-01
"Washington","2010-12",2010,12,59000,27327,31673,73.3791281985937,"12",2010-12-01
"Washington","2010-02",2010,2,46000,18184,27816,86.6758070547177,"02",2010-02-01
"Washington","2010-03",2010,3,50000,24824,25176,67.293916390463,"03",2010-03-01
"Washington","2010-04",2010,4,57000,24761,32239,78.8615599124277,"04",2010-04-01
"Washington","2010-05",2010,5,63000,29225,33775,73.2447817836812,"05",2010-05-01
"Washington","2010-06",2010,6,63000,27328,35672,78.9832610043397,"06",2010-06-01
"Washington","2010-07",2010,7,60000,28320,31680,71.7391304347826,"07",2010-07-01
"Washington","2010-08",2010,8,57000,27661,29339,69.3093632250977,"08",2010-08-01
"Washington","2010-09",2010,9,57000,23855,33145,81.986271720982,"09",2010-09-01
"Washington","2011-01",2011,1,51000,20804,30196,84.1067350008356,"01",2011-01-01
"Washington","2011-10",2011,10,77000,30061,46939,87.6864591214354,"10",2011-10-01
"Washington","2011-11",2011,11,79000,27769,51231,95.966057563525,"11",2011-11-01
"Washington","2011-12",2011,12,72000,27821,44179,88.5164444355396,"12",2011-12-01
"Washington","2011-02",2011,2,48000,19328,28672,85.1711026615969,"02",2011-02-01
"Washington","2011-03",2011,3,58000,34201,23799,51.624168935261,"03",2011-03-01
"Washington","2011-04",2011,4,64000,19911,44089,105.085149741989,"04",2011-04-01
"Washington","2011-05",2011,5,67000,28645,38355,80.2028333943228,"05",2011-05-01
"Washington","2011-06",2011,6,66000,25577,40423,88.2819922032825,"06",2011-06-01
"Washington","2011-07",2011,7,71000,32415,38585,74.6216699705072,"07",2011-07-01
"Washington","2011-08",2011,8,71000,28000,43000,86.8686868686869,"08",2011-08-01
"Washington","2011-09",2011,9,77000,28721,48279,91.332847778587,"09",2011-09-01
"Washington","2012-01",2012,1,70000,32763,37237,72.4716094314101,"01",2012-01-01
"Washington","2012-10",2012,10,96000,29373,66627,106.286042449331,"10",2012-10-01
"Washington","2012-11",2012,11,97000,34202,62798,95.7271992804988,"11",2012-11-01
"Washington","2012-12",2012,12,88000,31339,56661,94.9580606507512,"12",2012-12-01
"Washington","2012-02",2012,2,72000,29687,42313,83.222044115767,"02",2012-02-01
"Washington","2012-03",2012,3,81000,38295,42705,71.5956242927197,"03",2012-03-01
"Washington","2012-04",2012,4,87000,34653,52347,86.0595299745999,"04",2012-04-01
"Washington","2012-05",2012,5,96000,33107,62893,97.4277149960885,"05",2012-05-01
"Washington","2012-06",2012,6,99000,32145,66855,101.955850394601,"06",2012-06-01
"Washington","2012-07",2012,7,97000,25185,71815,117.551254245611,"07",2012-07-01
"Washington","2012-08",2012,8,90000,22873,67127,118.942528328298,"08",2012-08-01
"Washington","2012-09",2012,9,90000,37878,52122,81.5183221508,"09",2012-09-01
"Washington","2013-01",2013,1,80000,42107,37893,62.0652378651511,"01",2013-01-01
"Washington","2013-10",2013,10,86000,43881,42119,64.8578313995119,"10",2013-10-01
"Washington","2013-11",2013,11,84000,37142,46858,77.3604530220733,"11",2013-11-01
"Washington","2013-12",2013,12,80000,36185,43815,75.4228170590007,"12",2013-12-01
"Washington","2013-02",2013,2,83000,27895,55105,99.3822985707201,"02",2013-02-01
"Washington","2013-03",2013,3,89000,28712,60288,102.433056952562,"03",2013-03-01
"Washington","2013-04",2013,4,93000,31919,61081,97.7929698444592,"04",2013-04-01
"Washington","2013-05",2013,5,91000,33687,57313,91.9309952120109,"05",2013-05-01
"Washington","2013-06",2013,6,84000,34828,49172,82.7616386710203,"06",2013-06-01
"Washington","2013-07",2013,7,82000,50659,31341,47.2504692482229,"07",2013-07-01
"Washington","2013-08",2013,8,80000,45041,34959,55.9160595324733,"08",2013-08-01
"Washington","2013-09",2013,9,82000,43899,38101,60.5262948871715,"09",2013-09-01
"Washington","2014-01",2014,1,74000,42854,31146,53.3075461687234,"01",2014-01-01
"Washington","2014-10",2014,10,103000,35873,67127,96.6739394986786,"10",2014-10-01
"Washington","2014-11",2014,11,88000,35329,52671,85.4154335152316,"11",2014-11-01
"Washington","2014-12",2014,12,82000,38454,43546,72.3031198631843,"12",2014-12-01
"Washington","2014-02",2014,2,77000,43073,33927,56.5106227045214,"02",2014-02-01
"Washington","2014-03",2014,3,83000,42630,40370,64.2680888322853,"03",2014-03-01
"Washington","2014-04",2014,4,91000,54281,36719,50.548936199503,"04",2014-04-01
"Washington","2014-05",2014,5,99000,38327,60673,88.3628128481653,"05",2014-05-01
"Washington","2014-06",2014,6,107000,36353,70647,98.5636854478106,"06",2014-06-01
"Washington","2014-07",2014,7,113000,28704,84296,118.974764297409,"07",2014-07-01
"Washington","2014-08",2014,8,118000,44501,73499,90.4597510169168,"08",2014-08-01
"Washington","2014-09",2014,9,111000,44495,66505,85.5397279655294,"09",2014-09-01
"Washington","2015-01",2015,1,90000,43013,46987,70.6502371948607,"01",2015-01-01
"Washington","2015-10",2015,10,148000,52364,95636,95.4622586891857,"10",2015-10-01
"Washington","2015-11",2015,11,139000,44078,94922,103.695692546346,"11",2015-11-01
"Washington","2015-12",2015,12,138000,42569,95431,105.700314007388,"12",2015-12-01
"Washington","2015-02",2015,2,108000,27945,80055,117.775571002979,"02",2015-02-01
"Washington","2015-03",2015,3,125000,48069,76931,88.9021141856716,"03",2015-03-01
"Washington","2015-04",2015,4,139000,61371,77629,77.4852648337334,"04",2015-04-01
"Washington","2015-05",2015,5,147000,64558,82442,77.9379650025052,"05",2015-05-01
"Washington","2015-06",2015,6,143000,64653,78347,75.4595406760317,"06",2015-06-01
"Washington","2015-07",2015,7,146000,61156,84844,81.9131475796018,"07",2015-07-01
"Washington","2015-08",2015,8,142000,60902,81098,79.9380981951878,"08",2015-08-01
"Washington","2015-09",2015,9,155000,54439,100561,96.0289153405049,"09",2015-09-01
"Washington","2016-01",2016,1,142000,54650,87350,88.83803712179,"01",2016-01-01
"Washington","2016-10",2016,10,140000,49640,90360,95.2963509808057,"10",2016-10-01
"Washington","2016-11",2016,11,130000,44746,85254,97.574765659872,"11",2016-11-01
"Washington","2016-12",2016,12,122000,40647,81353,100.036274877495,"12",2016-12-01
"Washington","2016-02",2016,2,151000,48004,102996,103.511487206287,"02",2016-02-01
"Washington","2016-03",2016,3,156000,53709,102291,97.555183611576,"03",2016-03-01
"Washington","2016-04",2016,4,160000,53861,106139,99.259799589453,"04",2016-04-01
"Washington","2016-05",2016,5,164000,41684,122316,118.935843332491,"05",2016-05-01
"Washington","2016-06",2016,6,157000,48255,108745,105.960877932328,"06",2016-06-01
"Washington","2016-07",2016,7,148000,50075,97925,98.8766881231857,"07",2016-07-01
"Washington","2016-08",2016,8,147000,45869,101131,104.870145020714,"08",2016-08-01
"Washington","2016-09",2016,9,143000,54190,88810,90.0755616410569,"09",2016-09-01
"Washington","2017-01",2017,1,113000,43788,69212,88.2873689312958,"01",2017-01-01
"Washington","2017-10",2017,10,142000,44908,97092,103.892824277184,"10",2017-10-01
"Washington","2017-11",2017,11,136000,38952,97048,110.942429923636,"11",2017-11-01
"Washington","2017-12",2017,12,123000,32634,90366,116.126296310575,"12",2017-12-01
"Washington","2017-02",2017,2,111000,49346,61654,76.9012011525077,"02",2017-02-01
"Washington","2017-03",2017,3,115000,53802,61198,72.5086195661189,"03",2017-03-01
"Washington","2017-04",2017,4,127000,50756,76244,85.7850086635613,"04",2017-04-01
"Washington","2017-05",2017,5,136000,57654,78346,80.913381598108,"05",2017-05-01
"Washington","2017-06",2017,6,142000,57826,84174,84.2472951467777,"06",2017-06-01
"Washington","2017-07",2017,7,144000,56372,87628,87.4653145150021,"07",2017-07-01
"Washington","2017-08",2017,8,144000,52977,91023,92.4199271996223,"08",2017-08-01
"Washington","2017-09",2017,9,146000,45469,100531,105.010210530164,"09",2017-09-01
"Washington","2018-01",2018,1,127000,41151,85849,102.10941356281,"01",2018-01-01
"Washington","2018-10",2018,10,163000,73432,89568,75.7663937199702,"10",2018-10-01
"Washington","2018-11",2018,11,154000,68880,85120,76.3819095477387,"11",2018-11-01
"Washington","2018-12",2018,12,142000,60976,81024,79.8360397288349,"12",2018-12-01
"Washington","2018-02",2018,2,128000,38396,89604,107.699704319815,"02",2018-02-01
"Washington","2018-03",2018,3,140000,51416,88584,92.5565261002215,"03",2018-03-01
"Washington","2018-04",2018,4,149000,53014,95986,95.0290573920619,"04",2018-04-01
"Washington","2018-05",2018,5,160000,79396,80604,67.3394710020218,"05",2018-05-01
"Washington","2018-06",2018,6,173000,51413,121587,108.360032618431,"06",2018-06-01
"Washington","2018-07",2018,7,173000,74849,98151,79.2022562124519,"07",2018-07-01
"Washington","2018-08",2018,8,177000,69970,107030,86.6744948779204,"08",2018-08-01
"Washington","2018-09",2018,9,172000,59223,112777,97.5482542826622,"09",2018-09-01
"Washington","2019-01",2019,1,144000,65896,78104,74.4216183252659,"01",2019-01-01
"Washington","2019-10",2019,10,157000,76399,80601,69.0671339637274,"10",2019-10-01
"Washington","2019-11",2019,11,145000,78584,66416,59.4103334764563,"11",2019-11-01
"Washington","2019-12",2019,12,136000,73020,62980,60.262175868338,"12",2019-12-01
"Washington","2019-02",2019,2,142000,57474,84526,84.7488895795943,"02",2019-02-01
"Washington","2019-03",2019,3,151000,75576,75424,66.5772191229433,"03",2019-03-01
"Washington","2019-04",2019,4,160000,67624,92376,81.1654307102942,"04",2019-04-01
"Washington","2019-05",2019,5,169000,73190,95810,79.1196994095545,"05",2019-05-01
"Washington","2019-06",2019,6,173000,62331,110669,94.0539070500699,"06",2019-06-01
"Washington","2019-07",2019,7,170000,58067,111933,98.1579974305796,"07",2019-07-01
"Washington","2019-08",2019,8,174000,85725,88275,67.975743574935,"08",2019-08-01
"Washington","2019-09",2019,9,171000,83938,87062,68.3005279715068,"09",2019-09-01
"West Virginia","2010-01",2010,1,16000,1234,14766,171.358941627016,"01",2010-01-01
"West Virginia","2010-10",2010,10,20000,5035,14965,119.552626323148,"10",2010-10-01
"West Virginia","2010-11",2010,11,20000,3687,16313,137.737999746696,"11",2010-11-01
"West Virginia","2010-12",2010,12,19000,3818,15182,133.07038303094,"12",2010-12-01
"West Virginia","2010-02",2010,2,16000,4295,11705,115.348608031535,"02",2010-02-01
"West Virginia","2010-03",2010,3,17000,4029,12971,123.362974939369,"03",2010-03-01
"West Virginia","2010-04",2010,4,18000,3293,14707,138.13929460386,"04",2010-04-01
"West Virginia","2010-05",2010,5,19000,6519,12481,97.8173125906188,"05",2010-05-01
"West Virginia","2010-06",2010,6,18000,5998,12002,100.025002083507,"06",2010-06-01
"West Virginia","2010-07",2010,7,19000,4401,14599,124.772445621982,"07",2010-07-01
"West Virginia","2010-08",2010,8,19000,4511,14489,123.252945429799,"08",2010-08-01
"West Virginia","2010-09",2010,9,20000,3893,16107,134.826099694471,"09",2010-09-01
"West Virginia","2011-01",2011,1,18000,3006,14994,142.759211653813,"01",2011-01-01
"West Virginia","2011-10",2011,10,24000,5407,18593,126.45288536743,"10",2011-10-01
"West Virginia","2011-11",2011,11,24000,3451,20549,149.714035918546,"11",2011-11-01
"West Virginia","2011-12",2011,12,23000,3787,19213,143.450181057976,"12",2011-12-01
"West Virginia","2011-02",2011,2,18000,3239,14761,138.999011252884,"02",2011-02-01
"West Virginia","2011-03",2011,3,19000,5158,13842,114.59557910423,"03",2011-03-01
"West Virginia","2011-04",2011,4,21000,3484,17516,143.081195883026,"04",2011-04-01
"West Virginia","2011-05",2011,5,23000,5043,17957,128.067610455372,"05",2011-05-01
"West Virginia","2011-06",2011,6,23000,4932,18068,129.371330373765,"06",2011-06-01
"West Virginia","2011-07",2011,7,23000,5261,17739,125.536959060189,"07",2011-07-01
"West Virginia","2011-08",2011,8,22000,5472,16528,120.326150262085,"08",2011-08-01
"West Virginia","2011-09",2011,9,24000,5073,18927,130.203281395109,"09",2011-09-01
"West Virginia","2012-01",2012,1,24000,4452,19548,137.410375369043,"01",2012-01-01
"West Virginia","2012-10",2012,10,23000,4296,18704,137.04572098476,"10",2012-10-01
"West Virginia","2012-11",2012,11,22000,3466,18534,145.558784261368,"11",2012-11-01
"West Virginia","2012-12",2012,12,21000,3654,17346,140.715502555366,"12",2012-12-01
"West Virginia","2012-02",2012,2,24000,6060,17940,119.36127744511,"02",2012-02-01
"West Virginia","2012-03",2012,3,25000,4898,20102,134.47053314603,"03",2012-03-01
"West Virginia","2012-04",2012,4,25000,4219,20781,142.243061021938,"04",2012-04-01
"West Virginia","2012-05",2012,5,27000,5617,21383,131.115675874544,"05",2012-05-01
"West Virginia","2012-06",2012,6,25000,4821,20179,135.334160490929,"06",2012-06-01
"West Virginia","2012-07",2012,7,24000,4439,19561,137.564611976511,"07",2012-07-01
"West Virginia","2012-08",2012,8,22000,3823,18177,140.781473879875,"08",2012-08-01
"West Virginia","2012-09",2012,9,23000,4245,18755,137.676637915214,"09",2012-09-01
"West Virginia","2013-01",2013,1,21000,7905,13095,90.6071613907628,"01",2013-01-01
"West Virginia","2013-10",2013,10,27000,23377,3623,14.3835480477202,"10",2013-10-01
"West Virginia","2013-11",2013,11,25000,6552,18448,116.937119675456,"11",2013-11-01
"West Virginia","2013-12",2013,12,22000,5026,16974,125.612373270184,"12",2013-12-01
"West Virginia","2013-02",2013,2,21000,6248,14752,108.279506752789,"02",2013-02-01
"West Virginia","2013-03",2013,3,22000,5970,16030,114.622810153736,"03",2013-03-01
"West Virginia","2013-04",2013,4,24000,4969,19031,131.388725879388,"04",2013-04-01
"West Virginia","2013-05",2013,5,26000,4191,21809,144.473518598258,"05",2013-05-01
"West Virginia","2013-06",2013,6,27000,3898,23102,149.537186872937,"06",2013-06-01
"West Virginia","2013-07",2013,7,25000,8208,16792,101.132257287401,"07",2013-07-01
"West Virginia","2013-08",2013,8,24000,8817,15183,92.5313099917726,"08",2013-08-01
"West Virginia","2013-09",2013,9,26000,24892,1108,4.35431894993319,"09",2013-09-01
"West Virginia","2014-01",2014,1,21000,6254,14746,108.211638658546,"01",2014-01-01
"West Virginia","2014-10",2014,10,28000,6298,21702,126.549653040994,"10",2014-10-01
"West Virginia","2014-11",2014,11,26000,5317,20683,132.08800332088,"11",2014-11-01
"West Virginia","2014-12",2014,12,23000,5005,17995,128.512765577575,"12",2014-12-01
"West Virginia","2014-02",2014,2,22000,8079,13921,92.5629176501878,"02",2014-02-01
"West Virginia","2014-03",2014,3,24000,6939,17061,110.287986037041,"03",2014-03-01
"West Virginia","2014-04",2014,4,26000,7051,18949,114.665214365677,"04",2014-04-01
"West Virginia","2014-05",2014,5,27000,6534,20466,122.061191626409,"05",2014-05-01
"West Virginia","2014-06",2014,6,29000,5818,23182,133.161008673675,"06",2014-06-01
"West Virginia","2014-07",2014,7,27000,4624,22376,141.512775107513,"07",2014-07-01
"West Virginia","2014-08",2014,8,28000,6025,21975,129.169728141073,"08",2014-08-01
"West Virginia","2014-09",2014,9,28000,5998,22002,129.431143008412,"09",2014-09-01
"West Virginia","2015-01",2015,1,23000,5716,17284,120.378882852765,"01",2015-01-01
"West Virginia","2015-10",2015,10,31000,6245,24755,132.930594710699,"10",2015-10-01
"West Virginia","2015-11",2015,11,30000,4952,25048,143.327992675669,"11",2015-11-01
"West Virginia","2015-12",2015,12,27000,4561,22439,142.194480529768,"12",2015-12-01
"West Virginia","2015-02",2015,2,24000,4421,19579,137.778403293339,"02",2015-02-01
"West Virginia","2015-03",2015,3,26000,5164,20836,133.718393017584,"03",2015-03-01
"West Virginia","2015-04",2015,4,28000,5595,22405,133.38294389046,"04",2015-04-01
"West Virginia","2015-05",2015,5,29000,6708,22292,124.857174862776,"05",2015-05-01
"West Virginia","2015-06",2015,6,29000,6389,22611,127.785470061318,"06",2015-06-01
"West Virginia","2015-07",2015,7,29000,7520,21480,117.63417305586,"07",2015-07-01
"West Virginia","2015-08",2015,8,29000,6828,22172,123.769119124707,"08",2015-08-01
"West Virginia","2015-09",2015,9,31000,6242,24758,132.957413672735,"09",2015-09-01
"West Virginia","2016-01",2016,1,26000,5828,20172,126.756315194169,"01",2016-01-01
"West Virginia","2016-10",2016,10,31000,10684,20316,97.4762498800499,"10",2016-10-01
"West Virginia","2016-11",2016,11,30000,6998,23002,124.341856316558,"11",2016-11-01
"West Virginia","2016-12",2016,12,29000,5940,23060,131.997710360618,"12",2016-12-01
"West Virginia","2016-02",2016,2,25000,5932,19068,123.289796974008,"02",2016-02-01
"West Virginia","2016-03",2016,3,28000,7912,20088,111.873468478503,"03",2016-03-01
"West Virginia","2016-04",2016,4,30000,8885,21115,108.602288800309,"04",2016-04-01
"West Virginia","2016-05",2016,5,32000,6348,25652,133.785334306874,"05",2016-05-01
"West Virginia","2016-06",2016,6,31000,7415,23585,122.790576597683,"06",2016-06-01
"West Virginia","2016-07",2016,7,31000,8636,22364,112.846906852356,"07",2016-07-01
"West Virginia","2016-08",2016,8,32000,9293,22707,109.979899740876,"08",2016-08-01
"West Virginia","2016-09",2016,9,33000,10846,22154,101.053687907677,"09",2016-09-01
"West Virginia","2017-01",2017,1,28000,7265,20735,117.595349496668,"01",2017-01-01
"West Virginia","2017-10",2017,10,36000,6047,29953,142.473898256713,"10",2017-10-01
"West Virginia","2017-11",2017,11,33000,6699,26301,132.502078137988,"11",2017-11-01
"West Virginia","2017-12",2017,12,30000,5469,24531,138.323606529646,"12",2017-12-01
"West Virginia","2017-02",2017,2,28000,7740,20260,113.374370453274,"02",2017-02-01
"West Virginia","2017-03",2017,3,28000,11564,16436,83.0856334041047,"03",2017-03-01
"West Virginia","2017-04",2017,4,33000,7372,25628,126.959278708015,"04",2017-04-01
"West Virginia","2017-05",2017,5,34000,7887,26113,124.683075894669,"05",2017-05-01
"West Virginia","2017-06",2017,6,35000,7492,27508,129.473783300386,"06",2017-06-01
"West Virginia","2017-07",2017,7,38000,9894,28106,117.367519939867,"07",2017-07-01
"West Virginia","2017-08",2017,8,40000,8562,31438,129.475721757753,"08",2017-08-01
"West Virginia","2017-09",2017,9,42000,7052,34948,142.49368017614,"09",2017-09-01
"West Virginia","2018-01",2018,1,28000,8274,19726,108.761096101891,"01",2018-01-01
"West Virginia","2018-10",2018,10,44000,5889,38111,152.783178656618,"10",2018-10-01
"West Virginia","2018-11",2018,11,43000,4351,38649,163.2447044413,"11",2018-11-01
"West Virginia","2018-12",2018,12,38000,5673,32327,148.041123806471,"12",2018-12-01
"West Virginia","2018-02",2018,2,29000,7191,21809,120.521676659943,"02",2018-02-01
"West Virginia","2018-03",2018,3,32000,10322,21678,102.443173763055,"03",2018-03-01
"West Virginia","2018-04",2018,4,35000,6620,28380,136.376741950985,"04",2018-04-01
"West Virginia","2018-05",2018,5,38000,7624,30376,133.157987024373,"05",2018-05-01
"West Virginia","2018-06",2018,6,40000,5360,34640,152.733686067019,"06",2018-06-01
"West Virginia","2018-07",2018,7,41000,5933,35067,149.434299959517,"07",2018-07-01
"West Virginia","2018-08",2018,8,41000,6073,34927,148.395045992395,"08",2018-08-01
"West Virginia","2018-09",2018,9,45000,5519,39481,156.30158950098,"09",2018-09-01
"West Virginia","2019-01",2019,1,38000,4970,33030,153.735164067954,"01",2019-01-01
"West Virginia","2019-10",2019,10,47000,5697,41303,156.756551606353,"10",2019-10-01
"West Virginia","2019-11",2019,11,46000,16210,29790,95.7723838611156,"11",2019-11-01
"West Virginia","2019-12",2019,12,39000,6513,32487,142.759211653813,"12",2019-12-01
"West Virginia","2019-02",2019,2,37000,4503,32497,156.600727658242,"02",2019-02-01
"West Virginia","2019-03",2019,3,40000,7261,32739,138.545523793403,"03",2019-03-01
"West Virginia","2019-04",2019,4,43000,6583,36417,146.893088356897,"04",2019-04-01
"West Virginia","2019-05",2019,5,46000,7509,38491,143.867386794745,"05",2019-05-01
"West Virginia","2019-06",2019,6,45000,7257,37743,144.451461048281,"06",2019-06-01
"West Virginia","2019-07",2019,7,43000,4932,38068,158.841692397563,"07",2019-07-01
"West Virginia","2019-08",2019,8,42000,7388,34612,140.163602494533,"08",2019-08-01
"West Virginia","2019-09",2019,9,47000,7249,39751,146.550166823352,"09",2019-09-01
"Wisconsin","2010-01",2010,1,43000,5086,37914,157.692467662105,"01",2010-01-01
"Wisconsin","2010-10",2010,10,59000,20990,38010,95.0368796099512,"10",2010-10-01
"Wisconsin","2010-11",2010,11,56000,16526,39474,108.854755535946,"11",2010-11-01
"Wisconsin","2010-12",2010,12,52000,19053,32947,92.7392228336594,"12",2010-12-01
"Wisconsin","2010-02",2010,2,45000,11447,33553,118.883200170071,"02",2010-02-01
"Wisconsin","2010-03",2010,3,50000,12576,37424,119.611352595244,"03",2010-03-01
"Wisconsin","2010-04",2010,4,55000,14079,40921,118.475947827849,"04",2010-04-01
"Wisconsin","2010-05",2010,5,61000,15851,45149,117.497495152958,"05",2010-05-01
"Wisconsin","2010-06",2010,6,64000,16120,47880,119.520718921618,"06",2010-06-01
"Wisconsin","2010-07",2010,7,62000,18352,43648,108.641975308642,"07",2010-07-01
"Wisconsin","2010-08",2010,8,63000,19888,43112,104.024708039764,"08",2010-08-01
"Wisconsin","2010-09",2010,9,61000,16008,44992,116.85019738209,"09",2010-09-01
"Wisconsin","2011-01",2011,1,53000,17099,35901,102.429421247093,"01",2011-01-01
"Wisconsin","2011-10",2011,10,75000,23019,51981,106.063110213326,"10",2011-10-01
"Wisconsin","2011-11",2011,11,70000,16602,53398,123.318168171636,"11",2011-11-01
"Wisconsin","2011-12",2011,12,68000,16570,51430,121.627054511056,"12",2011-12-01
"Wisconsin","2011-02",2011,2,52000,13927,38073,115.500477801204,"02",2011-02-01
"Wisconsin","2011-03",2011,3,58000,20936,37064,93.9089895611635,"03",2011-03-01
"Wisconsin","2011-04",2011,4,59000,17147,41853,109.926852009928,"04",2011-04-01
"Wisconsin","2011-05",2011,5,64000,24592,39408,88.9651435795557,"05",2011-05-01
"Wisconsin","2011-06",2011,6,67000,25151,41849,90.82701218652,"06",2011-06-01
"Wisconsin","2011-07",2011,7,72000,22410,49590,105.052430886559,"07",2011-07-01
"Wisconsin","2011-08",2011,8,74000,22998,51002,105.16093115322,"08",2011-08-01
"Wisconsin","2011-09",2011,9,73000,23702,49298,101.958594444789,"09",2011-09-01
"Wisconsin","2012-01",2012,1,66000,25193,40807,89.4959042908995,"01",2012-01-01
"Wisconsin","2012-10",2012,10,78000,14639,63361,136.791200250434,"10",2012-10-01
"Wisconsin","2012-11",2012,11,74000,14750,59250,133.521126760563,"11",2012-11-01
"Wisconsin","2012-12",2012,12,71000,16020,54980,126.36175591818,"12",2012-12-01
"Wisconsin","2012-02",2012,2,68000,28258,39742,82.57391593426,"02",2012-02-01
"Wisconsin","2012-03",2012,3,74000,24213,49787,101.385763595451,"03",2012-03-01
"Wisconsin","2012-04",2012,4,72000,19745,52255,113.913564771922,"04",2012-04-01
"Wisconsin","2012-05",2012,5,77000,19112,57888,120.459463958715,"05",2012-05-01
"Wisconsin","2012-06",2012,6,76000,17167,58833,126.295791428295,"06",2012-06-01
"Wisconsin","2012-07",2012,7,78000,18170,59830,124.425496516585,"07",2012-07-01
"Wisconsin","2012-08",2012,8,78000,12418,65582,145.064035922051,"08",2012-08-01
"Wisconsin","2012-09",2012,9,77000,12269,64731,145.024588602986,"09",2012-09-01
"Wisconsin","2013-01",2013,1,65000,25756,39244,86.4824364229362,"01",2013-01-01
"Wisconsin","2013-10",2013,10,97000,36158,60842,91.3831688670602,"10",2013-10-01
"Wisconsin","2013-11",2013,11,88000,27207,60793,105.536989939847,"11",2013-11-01
"Wisconsin","2013-12",2013,12,83000,27115,55885,101.502974163375,"12",2013-12-01
"Wisconsin","2013-02",2013,2,69000,19635,49365,111.389405990861,"02",2013-02-01
"Wisconsin","2013-03",2013,3,77000,22659,54341,109.053873709349,"03",2013-03-01
"Wisconsin","2013-04",2013,4,89000,16723,72277,136.728999366268,"04",2013-04-01
"Wisconsin","2013-05",2013,5,94000,19072,74928,132.531484363945,"05",2013-05-01
"Wisconsin","2013-06",2013,6,95000,19485,75515,131.921212385902,"06",2013-06-01
"Wisconsin","2013-07",2013,7,89000,34430,54570,88.4225877015312,"07",2013-07-01
"Wisconsin","2013-08",2013,8,94000,31645,62355,99.2558398662899,"08",2013-08-01
"Wisconsin","2013-09",2013,9,91000,29697,61303,101.58164660265,"09",2013-09-01
"Wisconsin","2014-01",2014,1,78000,35329,42671,75.3046440010942,"01",2014-01-01
"Wisconsin","2014-10",2014,10,116000,23525,92475,132.556889446336,"10",2014-10-01
"Wisconsin","2014-11",2014,11,111000,21465,89535,135.182878496207,"11",2014-11-01
"Wisconsin","2014-12",2014,12,111000,22292,88708,133.103262011223,"12",2014-12-01
"Wisconsin","2014-02",2014,2,82000,28590,53410,96.5910118455557,"02",2014-02-01
"Wisconsin","2014-03",2014,3,90000,36080,53920,85.5329949238579,"03",2014-03-01
"Wisconsin","2014-04",2014,4,98000,32600,65400,100.153139356815,"04",2014-04-01
"Wisconsin","2014-05",2014,5,101000,30970,70030,106.130181101766,"05",2014-05-01
"Wisconsin","2014-06",2014,6,101000,26527,74473,116.795658958495,"06",2014-06-01
"Wisconsin","2014-07",2014,7,107000,19982,87018,137.055645682065,"07",2014-07-01
"Wisconsin","2014-08",2014,8,113000,25687,87313,125.913748224419,"08",2014-08-01
"Wisconsin","2014-09",2014,9,119000,24839,94161,130.925548703759,"09",2014-09-01
"Wisconsin","2015-01",2015,1,112000,23712,88288,130.110822919123,"01",2015-01-01
"Wisconsin","2015-10",2015,10,116000,28973,87027,120.059597304326,"10",2015-10-01
"Wisconsin","2015-11",2015,11,112000,23444,88556,130.76400578837,"11",2015-11-01
"Wisconsin","2015-12",2015,12,112000,23833,88167,129.816760286528,"12",2015-12-01
"Wisconsin","2015-02",2015,2,121000,20748,100252,141.451025764032,"02",2015-02-01
"Wisconsin","2015-03",2015,3,122000,23962,98038,134.333593675066,"03",2015-03-01
"Wisconsin","2015-04",2015,4,133000,26313,106687,133.933828375588,"04",2015-04-01
"Wisconsin","2015-05",2015,5,132000,30346,101654,125.231296120631,"05",2015-05-01
"Wisconsin","2015-06",2015,6,135000,30486,104514,126.31159131286,"06",2015-06-01
"Wisconsin","2015-07",2015,7,131000,33612,97388,118.324301994994,"07",2015-07-01
"Wisconsin","2015-08",2015,8,125000,31440,93560,119.611352595244,"08",2015-08-01
"Wisconsin","2015-09",2015,9,118000,28174,89826,122.902841818654,"09",2015-09-01
"Wisconsin","2016-01",2016,1,113000,30998,82002,113.893248517341,"01",2016-01-01
"Wisconsin","2016-10",2016,10,110000,39582,70418,94.1530398042545,"10",2016-10-01
"Wisconsin","2016-11",2016,11,111000,38081,72919,97.8246724934767,"11",2016-11-01
"Wisconsin","2016-12",2016,12,107000,31341,75659,109.380443975394,"12",2016-12-01
"Wisconsin","2016-02",2016,2,116000,32503,83497,112.451600304371,"02",2016-02-01
"Wisconsin","2016-03",2016,3,131000,46051,84949,95.9599211526622,"03",2016-03-01
"Wisconsin","2016-04",2016,4,131000,37939,93061,110.171126856439,"04",2016-04-01
"Wisconsin","2016-05",2016,5,133000,27473,105527,131.519944165062,"05",2016-05-01
"Wisconsin","2016-06",2016,6,118000,34076,83924,110.371130224362,"06",2016-06-01
"Wisconsin","2016-07",2016,7,114000,34845,79155,106.358964022977,"07",2016-07-01
"Wisconsin","2016-08",2016,8,112000,34126,77874,106.584728248224,"08",2016-08-01
"Wisconsin","2016-09",2016,9,114000,42301,71699,91.7447745056014,"09",2016-09-01
"Wisconsin","2017-01",2017,1,107000,31992,75008,107.931391734776,"01",2017-01-01
"Wisconsin","2017-10",2017,10,137000,29727,107273,128.681017471675,"10",2017-10-01
"Wisconsin","2017-11",2017,11,140000,28266,111734,132.806389882686,"11",2017-11-01
"Wisconsin","2017-12",2017,12,133000,22150,110850,142.893973573961,"12",2017-12-01
"Wisconsin","2017-02",2017,2,107000,28931,78069,114.865630356578,"02",2017-02-01
"Wisconsin","2017-03",2017,3,110000,39421,70579,94.4699874850255,"03",2017-03-01
"Wisconsin","2017-04",2017,4,116000,30477,85523,116.773281812162,"04",2017-04-01
"Wisconsin","2017-05",2017,5,117000,30868,86132,116.498498660968,"05",2017-05-01
"Wisconsin","2017-06",2017,6,125000,30841,94159,120.839830339898,"06",2017-06-01
"Wisconsin","2017-07",2017,7,127000,37109,89891,109.550359821826,"07",2017-07-01
"Wisconsin","2017-08",2017,8,131000,33289,97711,118.950142736276,"08",2017-08-01
"Wisconsin","2017-09",2017,9,133000,30521,102479,125.340476146795,"09",2017-09-01
"Wisconsin","2018-01",2018,1,131000,31112,99888,123.233320173707,"01",2018-01-01
"Wisconsin","2018-10",2018,10,163000,51484,111516,103.985378862759,"10",2018-10-01
"Wisconsin","2018-11",2018,11,164000,47104,116896,110.747309383053,"11",2018-11-01
"Wisconsin","2018-12",2018,12,165000,44835,120165,114.532847237115,"12",2018-12-01
"Wisconsin","2018-02",2018,2,131000,30778,100222,123.900653982618,"02",2018-02-01
"Wisconsin","2018-03",2018,3,135000,38593,96407,111.072451078096,"03",2018-03-01
"Wisconsin","2018-04",2018,4,142000,38658,103342,114.406226128929,"04",2018-04-01
"Wisconsin","2018-05",2018,5,151000,51539,99461,98.214171097912,"05",2018-05-01
"Wisconsin","2018-06",2018,6,156000,36429,119571,124.275447048002,"06",2018-06-01
"Wisconsin","2018-07",2018,7,153000,47957,105043,104.542762879621,"07",2018-07-01
"Wisconsin","2018-08",2018,8,152000,44118,107882,110.017438480915,"08",2018-08-01
"Wisconsin","2018-09",2018,9,154000,44743,109257,109.948023326608,"09",2018-09-01
"Wisconsin","2019-01",2019,1,162000,46962,115038,110.10422947713,"01",2019-01-01
"Wisconsin","2019-10",2019,10,158000,53705,104295,98.5286129283673,"10",2019-10-01
"Wisconsin","2019-11",2019,11,152000,64586,87414,80.7198987930891,"11",2019-11-01
"Wisconsin","2019-12",2019,12,144000,55472,88528,88.762332557953,"12",2019-12-01
"Wisconsin","2019-02",2019,2,157000,40186,116814,118.481028064873,"02",2019-02-01
"Wisconsin","2019-03",2019,3,154000,54676,99324,95.1944641453737,"03",2019-03-01
"Wisconsin","2019-04",2019,4,155000,49325,105675,103.438150006118,"04",2019-04-01
"Wisconsin","2019-05",2019,5,158000,54758,103242,97.0511097115032,"05",2019-05-01
"Wisconsin","2019-06",2019,6,161000,44450,116550,113.458262350937,"06",2019-06-01
"Wisconsin","2019-07",2019,7,159000,40046,118954,119.52413010058,"07",2019-07-01
"Wisconsin","2019-08",2019,8,159000,53415,105585,99.413883200339,"08",2019-08-01
"Wisconsin","2019-09",2019,9,156000,61094,94906,87.4330934986688,"09",2019-09-01
"Wyoming","2010-01",2010,1,7000,89,6911,194.978135138948,"01",2010-01-01
"Wyoming","2010-10",2010,10,9000,2824,6176,104.46549391069,"10",2010-10-01
"Wyoming","2010-11",2010,11,8000,2279,5721,111.314330187761,"11",2010-11-01
"Wyoming","2010-12",2010,12,9000,1714,7286,136.00896023894,"12",2010-12-01
"Wyoming","2010-02",2010,2,7000,1761,5239,119.598219381349,"02",2010-02-01
"Wyoming","2010-03",2010,3,8000,1150,6850,149.726775956284,"03",2010-03-01
"Wyoming","2010-04",2010,4,9000,1388,7612,146.553715825953,"04",2010-04-01
"Wyoming","2010-05",2010,5,10000,2096,7904,130.687830687831,"05",2010-05-01
"Wyoming","2010-06",2010,6,11000,2863,8137,117.391617975907,"06",2010-06-01
"Wyoming","2010-07",2010,7,11000,2052,8948,137.11308611707,"07",2010-07-01
"Wyoming","2010-08",2010,8,10000,2211,7789,127.573499303906,"08",2010-08-01
"Wyoming","2010-09",2010,9,9000,2648,6352,109.065934065934,"09",2010-09-01
"Wyoming","2011-01",2011,1,8000,1478,6522,137.623971301962,"01",2011-01-01
"Wyoming","2011-10",2011,10,10000,1814,8186,138.581344167936,"10",2011-10-01
"Wyoming","2011-11",2011,11,9000,1403,7597,146.054022878016,"11",2011-11-01
"Wyoming","2011-12",2011,12,9000,1865,7135,131.339162448228,"12",2011-12-01
"Wyoming","2011-02",2011,2,7000,1132,5868,144.318740777177,"02",2011-02-01
"Wyoming","2011-03",2011,3,7000,2950,4050,81.4070351758794,"03",2011-03-01
"Wyoming","2011-04",2011,4,8000,2039,5961,118.756848291663,"04",2011-04-01
"Wyoming","2011-05",2011,5,9000,2181,6819,121.97477864234,"05",2011-05-01
"Wyoming","2011-06",2011,6,11000,2070,8930,136.648814078041,"06",2011-06-01
"Wyoming","2011-07",2011,7,12000,2496,9504,131.12582781457,"07",2011-07-01
"Wyoming","2011-08",2011,8,12000,1846,10154,146.670518561317,"08",2011-08-01
"Wyoming","2011-09",2011,9,10000,2106,7894,130.414670411366,"09",2011-09-01
"Wyoming","2012-01",2012,1,8000,2290,5710,110.981535471331,"01",2012-01-01
"Wyoming","2012-10",2012,10,9000,1808,7192,133.086602516654,"10",2012-10-01
"Wyoming","2012-11",2012,11,8000,1509,6491,136.523293721737,"11",2012-11-01
"Wyoming","2012-12",2012,12,8000,1721,6279,129.184240304495,"12",2012-12-01
"Wyoming","2012-02",2012,2,8000,1989,6011,120.352387626389,"02",2012-02-01
"Wyoming","2012-03",2012,3,8000,3065,4935,89.200180750113,"03",2012-03-01
"Wyoming","2012-04",2012,4,9000,1712,7288,136.071695294996,"04",2012-04-01
"Wyoming","2012-05",2012,5,10000,1988,8012,133.667000333667,"05",2012-05-01
"Wyoming","2012-06",2012,6,12000,1826,10174,147.17199479242,"06",2012-06-01
"Wyoming","2012-07",2012,7,12000,1635,10365,152.035203520352,"07",2012-07-01
"Wyoming","2012-08",2012,8,11000,1535,9465,151.017151974471,"08",2012-08-01
"Wyoming","2012-09",2012,9,9000,1688,7312,136.826347305389,"09",2012-09-01
"Wyoming","2013-01",2013,1,8000,2428,5572,106.86612965094,"01",2013-01-01
"Wyoming","2013-10",2013,10,10000,2795,7205,112.62211801485,"10",2013-10-01
"Wyoming","2013-11",2013,11,9000,2402,6598,115.734081740046,"11",2013-11-01
"Wyoming","2013-12",2013,12,9000,2262,6738,119.659030367608,"12",2013-12-01
"Wyoming","2013-02",2013,2,8000,2047,5953,118.503035732059,"02",2013-02-01
"Wyoming","2013-03",2013,3,9000,2685,6315,108.08729139923,"03",2013-03-01
"Wyoming","2013-04",2013,4,10000,1908,8092,135.908632851864,"04",2013-04-01
"Wyoming","2013-05",2013,5,12000,2339,9661,134.751377362438,"05",2013-05-01
"Wyoming","2013-06",2013,6,13000,2250,10750,140.983606557377,"06",2013-06-01
"Wyoming","2013-07",2013,7,13000,2887,10113,127.311638446529,"07",2013-07-01
"Wyoming","2013-08",2013,8,11000,3165,7835,110.62477938581,"08",2013-08-01
"Wyoming","2013-09",2013,9,10000,2697,7303,115.035047649051,"09",2013-09-01
"Wyoming","2014-01",2014,1,9000,2954,6046,101.154425296972,"01",2014-01-01
"Wyoming","2014-10",2014,10,12000,3453,8547,110.61929722384,"10",2014-10-01
"Wyoming","2014-11",2014,11,11000,3280,7720,108.12324929972,"11",2014-11-01
"Wyoming","2014-12",2014,12,11000,3317,7683,107.326953970804,"12",2014-12-01
"Wyoming","2014-02",2014,2,10000,2786,7214,112.842171124668,"02",2014-02-01
"Wyoming","2014-03",2014,3,10000,3134,6866,104.553068372164,"03",2014-03-01
"Wyoming","2014-04",2014,4,11000,2853,8147,117.620731971414,"04",2014-04-01
"Wyoming","2014-05",2014,5,13000,2787,10213,129.384936973459,"05",2014-05-01
"Wyoming","2014-06",2014,6,17000,2719,14281,144.845073279578,"06",2014-06-01
"Wyoming","2014-07",2014,7,17000,2269,14731,152.898437905444,"07",2014-07-01
"Wyoming","2014-08",2014,8,15000,3015,11985,133.055786844296,"08",2014-08-01
"Wyoming","2014-09",2014,9,12000,2941,9059,121.26363697209,"09",2014-09-01
"Wyoming","2015-01",2015,1,11000,3166,7834,110.602851898913,"01",2015-01-01
"Wyoming","2015-10",2015,10,12000,3037,8963,119.212608898051,"10",2015-10-01
"Wyoming","2015-11",2015,11,11000,2551,8449,124.699284185669,"11",2015-11-01
"Wyoming","2015-12",2015,12,11000,2667,8333,121.943367234945,"12",2015-12-01
"Wyoming","2015-02",2015,2,12000,3032,8968,119.318786588611,"02",2015-02-01
"Wyoming","2015-03",2015,3,12000,3287,8713,113.992281023092,"03",2015-03-01
"Wyoming","2015-04",2015,4,13000,3214,9786,120.710497101271,"04",2015-04-01
"Wyoming","2015-05",2015,5,14000,4060,9940,110.077519379845,"05",2015-05-01
"Wyoming","2015-06",2015,6,16000,3398,12602,129.930920713476,"06",2015-06-01
"Wyoming","2015-07",2015,7,17000,3867,13133,125.873388604016,"07",2015-07-01
"Wyoming","2015-08",2015,8,15000,3691,11309,121.010111818522,"08",2015-08-01
"Wyoming","2015-09",2015,9,13000,3242,9758,120.157616057136,"09",2015-09-01
"Wyoming","2016-01",2016,1,10000,3178,6822,103.536196691455,"01",2016-01-01
"Wyoming","2016-10",2016,10,11000,4708,6292,80.1120448179272,"10",2016-10-01
"Wyoming","2016-11",2016,11,11000,4121,6879,90.9860458964354,"11",2016-11-01
"Wyoming","2016-12",2016,12,11000,3758,7242,98.1433798617699,"12",2016-12-01
"Wyoming","2016-02",2016,2,10000,2833,7167,111.696407698901,"02",2016-02-01
"Wyoming","2016-03",2016,3,10000,3351,6649,99.6030259905625,"03",2016-03-01
"Wyoming","2016-04",2016,4,11000,3821,7179,96.8760542473517,"04",2016-04-01
"Wyoming","2016-05",2016,5,14000,3369,10631,122.413495307732,"05",2016-05-01
"Wyoming","2016-06",2016,6,17000,4298,12702,119.278805521645,"06",2016-06-01
"Wyoming","2016-07",2016,7,17000,3650,13350,129.297820823245,"07",2016-07-01
"Wyoming","2016-08",2016,8,15000,4799,10201,103.045608364059,"08",2016-08-01
"Wyoming","2016-09",2016,9,12000,5003,6997,82.3031229782979,"09",2016-09-01
"Wyoming","2017-01",2017,1,11000,3757,7243,98.1635833841567,"01",2017-01-01
"Wyoming","2017-10",2017,10,14000,3238,10762,124.863673279963,"10",2017-10-01
"Wyoming","2017-11",2017,11,12000,4127,7873,97.637502325293,"11",2017-11-01
"Wyoming","2017-12",2017,12,11000,2747,8253,120.0698334182,"12",2017-12-01
"Wyoming","2017-02",2017,2,11000,4368,6632,86.3092139510672,"02",2017-02-01
"Wyoming","2017-03",2017,3,10000,5025,4975,66.2229617304492,"03",2017-03-01
"Wyoming","2017-04",2017,4,11000,3533,7467,102.759237597193,"04",2017-04-01
"Wyoming","2017-05",2017,5,14000,3705,10295,116.294831968371,"05",2017-05-01
"Wyoming","2017-06",2017,6,17000,3859,13141,125.99837000815,"06",2017-06-01
"Wyoming","2017-07",2017,7,18000,4039,13961,126.693588638323,"07",2017-07-01
"Wyoming","2017-08",2017,8,18000,3070,14930,141.71808258187,"08",2017-08-01
"Wyoming","2017-09",2017,9,15000,3809,11191,118.996225211335,"09",2017-09-01
"Wyoming","2018-01",2018,1,12000,3454,8546,110.599197618739,"01",2018-01-01
"Wyoming","2018-10",2018,10,16000,3009,12991,136.682624020201,"10",2018-10-01
"Wyoming","2018-11",2018,11,15000,2222,12778,148.391592149576,"11",2018-11-01
"Wyoming","2018-12",2018,12,15000,2923,12077,134.765385259164,"12",2018-12-01
"Wyoming","2018-02",2018,2,12000,4471,7529,91.421285896424,"02",2018-02-01
"Wyoming","2018-03",2018,3,12000,5394,6606,75.9572266298724,"03",2018-03-01
"Wyoming","2018-04",2018,4,13000,3378,9622,117.499084137257,"04",2018-04-01
"Wyoming","2018-05",2018,5,16000,3400,12600,129.896907216495,"05",2018-05-01
"Wyoming","2018-06",2018,6,19000,2740,16260,149.586016559338,"06",2018-06-01
"Wyoming","2018-07",2018,7,19000,3054,15946,144.608687766392,"07",2018-07-01
"Wyoming","2018-08",2018,8,19000,3175,15825,142.728297632469,"08",2018-08-01
"Wyoming","2018-09",2018,9,17000,3232,13768,136.101225780941,"09",2018-09-01
"Wyoming","2019-01",2019,1,15000,2594,12406,141.025349550983,"01",2019-01-01
"Wyoming","2019-10",2019,10,16000,2673,13327,142.740855781074,"10",2019-10-01
"Wyoming","2019-11",2019,11,15000,3665,11335,121.457272970801,"11",2019-11-01
"Wyoming","2019-12",2019,12,14000,2497,11503,139.455658604595,"12",2019-12-01
"Wyoming","2019-02",2019,2,14000,2187,11813,145.956631865077,"02",2019-02-01
"Wyoming","2019-03",2019,3,14000,5050,8950,93.9632545931758,"03",2019-03-01
"Wyoming","2019-04",2019,4,14000,2838,11162,132.581066634992,"04",2019-04-01
"Wyoming","2019-05",2019,5,17000,2680,14320,145.528455284553,"05",2019-05-01
"Wyoming","2019-06",2019,6,21000,2456,18544,158.117326057299,"06",2019-06-01
"Wyoming","2019-07",2019,7,21000,2523,18477,157.097309016707,"07",2019-07-01
"Wyoming","2019-08",2019,8,20000,2749,17251,151.663809398215,"08",2019-08-01
"Wyoming","2019-09",2019,9,17000,5391,11609,103.693448260462,"09",2019-09-01
